REB = "countries/Rebels.txt"

AAC = "countries/Aachen.txt"
ABB = "countries/Dongola.txt"
ABE = "countries/Abenaki.txt"
ABI = "countries/Abihka.txt"
ACH = "countries/PrincipalityOfAchaia.txt"
ACO = "countries/Acoma.txt"
ADA = "countries/Adal.txt"
ADE = "countries/Aden.txt"
ADU = "countries/Andalusia.txt"
AFA = "countries/Afar.txt"
AFG = "countries/Afghanistan.txt"
AGG = "countries/Attigneenongnahac.txt"
AGQ = "countries/Algonquin.txt"
AHM = "countries/Ahmadnagar.txt"
AIR = "countries/Air.txt"
AJU = "countries/Ajuuraan.txt"
AKK = "countries/AkKoyunlu.txt"
AKM = "countries/Akamatsu.txt"
AKS = "countries/Aksumite Empire.txt"
AKT = "countries/Ando.txt"
ALA = "countries/Alaska.txt"
ALB = "countries/Albania.txt"
ALE = "countries/Alencon.txt"
ALG = "countries/Algiers.txt"
ALH = "countries/Haasa.txt"
ALO = "countries/Alodia.txt"
ALS = "countries/Alsace.txt"
ALT = "countries/Altamaha.txt"
AMA = "countries/Amago.txt"
AMG = "countries/Armagnac.txt"
ANH = "countries/Anhalt.txt"
ANL = "countries/Anilco.txt"
ANN = "countries/Annam.txt"
ANS = "countries/Ansbach.txt"
ANT = "countries/Antemoro.txt"
ANU = "countries/Ainu.txt"
ANZ = "countries/Anizah.txt"
AOT = "countries/Aotearoa.txt"
APA = "countries/Apache.txt"
AQU = "countries/Aquileia.txt"
ARA = "countries/Aragon.txt"
ARB = "countries/Arabia.txt"
ARD = "countries/Ardalan.txt"
ARK = "countries/Arakan.txt"
ARL = "countries/Ardabil.txt"
ARM = "countries/Armenia.txt"
ARN = "countries/Arendaronon.txt"
ARP = "countries/Arapaho.txt"
ARW = "countries/Arawak.txt"
ASA = "countries/Asakura.txt"
ASH = "countries/Ashanti.txt"
ASI = "countries/Assiniboine.txt"
ASK = "countries/Ashikaga.txt"
ASS = "countries/Assam.txt"
AST = "countries/Astrakhan.txt"
ASU = "countries/Asturias.txt"
ATA = "countries/Atahachi.txt"
ATH = "countries/Athens.txt"
ATJ = "countries/Atjeh.txt"
ATT = "countries/Attignawantan.txt"
ATW = "countries/Attiwandaron.txt"
AUG = "countries/Augsburg.txt"
AUS = "countries/Australia.txt"
AUV = "countries/Auvergne.txt"
AVA = "countries/Ava.txt"
AVI = "countries/Avignon.txt"
AVR = "countries/Avars.txt"
AWN = "countries/Awngthim.txt"
AYD = "countries/Aydin.txt"
AYU = "countries/Ayutthaya.txt"
AZT = "countries/Aztec.txt"
BAD = "countries/Baden.txt"
BAH = "countries/Bahmanis.txt"
BAL = "countries/Baluchistan.txt"
BAM = "countries/Bamberg.txt"
BAN = "countries/Banten.txt"
BAR = "countries/Bar.txt"
BAV = "countries/Bavaria.txt"
BDA = "countries/Baroda.txt"
BEI = "countries/Brunei.txt"
BEJ = "countries/Beja.txt"
BEN = "countries/Benin.txt"
BER = "countries/Berry.txt"
BEU = "countries/Berau.txt"
BGA = "countries/Baglana.txt"
BGL = "countries/Bagelkhand.txt"
BHA = "countries/Bharat.txt"
BHT = "countries/Bohtan.txt"
BHU = "countries/Bhutan.txt"
BIJ = "countries/Bijapur.txt"
BLA = "countries/Blackfoot.txt"
BLG = "countries/Bologna.txt"
BLI = "countries/Bali.txt"
BLM = "countries/Blambangan.txt"
BLO = "countries/Beloozero.txt"
BND = "countries/Bundelkhand.txt"
BNE = "countries/Bone.txt"
BNG = "countries/Bengal.txt"
BNJ = "countries/Banjar.txt"
BNY = "countries/Bunyoro.txt"
BOH = "countries/Bohemia.txt"
BON = "countries/Bonoman.txt"
BOS = "countries/Bosnia.txt"
BOU = "countries/Bourbonnais.txt"
BPI = "countries/Biapas.txt"
BPR = "countries/Prome.txt"
BRA = "countries/Brandenburg.txt"
BRB = "countries/Brabant.txt"
BRE = "countries/Bremen.txt"
BRG = "countries/Berg.txt"
BRI = "countries/Brittany.txt"
BRR = "countries/Berar.txt"
BRS = "countries/Barus.txt"
BRT = "countries/Buryats.txt"
BRU = "countries/Brunswick.txt"
BRZ = "countries/Brazil.txt"
BSG = "countries/Basoga.txt"
BSH = "countries/Bashkiria.txt"
BSR = "countries/Basra.txt"
BST = "countries/Bastar.txt"
BTI = "countries/Semien.txt"
BTL = "countries/Bitlis.txt"
BTN = "countries/Buton.txt"
BTS = "countries/Betsimisaraka.txt"
BTU = "countries/Butuan.txt"
BUG = "countries/Buganda.txt"
BUK = "countries/Bukhara.txt"
BUL = "countries/Bulgaria.txt"
BUR = "countries/Burgundy.txt"
BUU = "countries/Burundi.txt"
BYT = "countries/Bayreuth.txt"
BYZ = "countries/ByzantineEmpire.txt"
CAB = "countries/Carib.txt"
CAD = "countries/Caddo.txt"
CAL = "countries/California.txt"
CAM = "countries/UPCA.txt"
CAN = "countries/Canada.txt"
CAO = "countries/Cahokia.txt"
CAQ = "countries/Casqui.txt"
CAS = "countries/Castille.txt"
CAT = "countries/Catalunya.txt"
CAY = "countries/Cayuga.txt"
CBA = "countries/Chiba.txt"
CCA = "countries/Chisca.txt"
CCM = "countries/Chichimeca.txt"
CCQ = "countries/Calchaqui.txt"
CDL = "countries/Dali.txt"
CEB = "countries/Cebu.txt"
CEP = "countries/Corfu.txt"
CEY = "countries/Ceylon.txt"
CGS = "countries/Changsheng.txt"
CHA = "countries/Champa.txt"
CHC = "countries/Chu.txt"
CHD = "countries/Chanda.txt"
CHE = "countries/Cherokee.txt"
CHG = "countries/ChagataiKhanate.txt"
CHH = "countries/Chahar.txt"
CHI = "countries/Chickasaw.txt"
CHK = "countries/Champassak.txt"
CHL = "countries/Chile.txt"
CHM = "countries/Chimu.txt"
CHO = "countries/Choctaw.txt"
CHP = "countries/Champagne.txt"
CHR = "countries/Chernigov.txt"
CHT = "countries/Chorti.txt"
CHU = "countries/Chukchi.txt"
CHV = "countries/Chavchuveny.txt"
CHY = "countries/Cheyenne.txt"
CIA = "countries/Chiaha.txt"
CIR = "countries/Circassia.txt"
CJA = "countries/Cajamarca.txt"
CKW = "countries/Chokwe.txt"
CLA = "countries/Colla.txt"
CLB = "countries/Calenberg.txt"
CLG = "countries/Chalahgawtha.txt"
CLI = "countries/Cilli.txt"
CLM = "countries/Colima.txt"
CMI = "countries/Miao.txt"
CMP = "countries/RewaKantha.txt"
CND = "countries/Candar.txt"
CNK = "countries/Chinook.txt"
CNN = "countries/Connacht.txt"
CNP = "countries/Can Pech.txt"
COB = "countries/Coburg.txt"
COC = "countries/Cocomes.txt"
COF = "countries/Cofitachequi.txt"
COI = "countries/Coixtlahuaca.txt"
COL = "countries/Colombia.txt"
COM = "countries/Comanche.txt"
COO = "countries/Coosa.txt"
COR = "countries/Corsica.txt"
COW = "countries/Coweta.txt"
CRA = "countries/Charca.txt"
CRB = "countries/Cirebon.txt"
CRE = "countries/Creek.txt"
CRI = "countries/Crimea.txt"
CRN = "countries/Cornwall.txt"
CRO = "countries/Croatia.txt"
CRT = "countries/Crete.txt"
CSC = "countries/Cascadia.txt"
CSH = "countries/Shun.txt"
CSK = "countries/Chosokabe.txt"
CSU = "countries/Cusco.txt"
CTM = "countries/Chactemal.txt"
CUA = "countries/Charrua.txt"
CUB = "countries/Cuba.txt"
CXI = "countries/Xi.txt"
CYA = "countries/Chachapoya.txt"
CYI = "countries/Yi.txt"
CYP = "countries/Cyprus.txt"
CZH = "countries/Zhou.txt"
DAH = "countries/Dahomey.txt"
DAI = "countries/DaiViet.txt"
DAL = "countries/Dalmatia.txt"
DAM = "countries/Damot.txt"
DAN = "countries/Denmark.txt"
DAR = "countries/Darfur.txt"
DAU = "countries/Dauphine.txt"
DAW = "countries/Dawasir.txt"
DEC = "countries/Deccan.txt"
DGB = "countries/Dagbon.txt"
DGL = "countries/Maldives.txt"
DHU = "countries/Dhundhar.txt"
DLH = "countries/Delhi.txt"
DLI = "countries/Deli.txt"
DMK = "countries/Demak.txt"
DMS = "countries/Desmond.txt"
DNG = "countries/Dang.txt"
DNZ = "countries/Danzig.txt"
DTE = "countries/Date.txt"
DTI = "countries/Doti.txt"
DTT = "countries/Dithmarschen.txt"
DUL = "countries/Dulkadir.txt"
DWT = "countries/Donauwoerth.txt"
EFR = "countries/EastFrisia.txt"
EGY = "countries/Egypt.txt"
EJZ = "countries/EastJianzhou.txt"
ENA = "countries/Eneara.txt"
ENG = "countries/England.txt"
EOR = "countries/Eora.txt"
EPI = "countries/Epirus.txt"
ERE = "countries/Eretna.txt"
ERI = "countries/Erie.txt"
EST = "countries/Estonia.txt"
ETH = "countries/Ethiopia.txt"
ETO = "countries/Etowah.txt"
ETR = "countries/Etruria.txt"
FAD = "countries/Fadl.txt"
FEO = "countries/Theodoro.txt"
FER = "countries/Ferrara.txt"
FEZ = "countries/Fez.txt"
FIN = "countries/Finland.txt"
FKN = "countries/Franconia.txt"
FLA = "countries/Flanders.txt"
FLO = "countries/Florida.txt"
FLY = "countries/Faly.txt"
FOI = "countries/Foix.txt"
FOX = "countries/Fox.txt"
FRA = "countries/France.txt"
FRI = "countries/Friesland.txt"
FRM = "countries/Formosa.txt"
FRN = "countries/Frankfurt.txt"
FRS = "countries/Fars.txt"
FUL = "countries/Fulo.txt"
FZA = "countries/Fezzan.txt"
GAL = "countries/Galicia.txt"
GAM = "countries/Guamar.txt"
GAZ = "countries/Gazikumukh.txt"
GBR = "countries/GreatBritain.txt"
GDW = "countries/Gondwana.txt"
GEL = "countries/Gelre.txt"
GEN = "countries/Genoa.txt"
GEO = "countries/Georgia.txt"
GER = "countries/Germany.txt"
GHD = "countries/Ghadames.txt"
GHR = "countries/Garhwal.txt"
GLE = "countries/Geledi.txt"
GLG = "countries/Glogau.txt"
GLH = "countries/GoldenHorde.txt"
GMI = "countries/Gamilaraay.txt"
GNG = "countries/Gingee.txt"
GNV = "countries/Geneva.txt"
GOC = "countries/Golconda.txt"
GOL = "countries/GreatHorde.txt"
GOS = "countries/Goslar.txt"
GOT = "countries/Gotland.txt"
GRA = "countries/Granada.txt"
GRE = "countries/Greece.txt"
GRJ = "countries/Garjat.txt"
GRK = "countries/Gorkha.txt"
GRM = "countries/Germiyan.txt"
GUA = "countries/Guarani.txt"
GUG = "countries/Guge.txt"
GUJ = "countries/Gujarat.txt"
GUR = "countries/Gurma.txt"
GUY = "countries/Gascony.txt"
GWA = "countries/Gwalior.txt"
GZI = "countries/Great Zimbabwe.txt"
HAB = "countries/Austria.txt"
HAD = "countries/Hadoti.txt"
HAI = "countries/Hainaut.txt"
HAM = "countries/Hamburg.txt"
HAN = "countries/Hannover.txt"
HAR = "countries/Harar.txt"
HAT = "countries/Haiti.txt"
HAU = "countries/Hausa.txt"
HAW = "countries/Hawaii.txt"
HDA = "countries/Haida.txt"
HDR = "countries/Hadramut.txt"
HDY = "countries/Hadiya.txt"
HED = "countries/Hedjaz.txt"
HES = "countries/Hessen.txt"
HIN = "countries/Hindustan.txt"
HJA = "countries/Huyla.txt"
HJO = "countries/Hojo.txt"
HLR = "countries/HolyRomanEmpire.txt"
HMI = "countries/Karadel.txt"
HNI = "countries/Hasinai.txt"
HOB = "countries/Hobyo.txt"
HOD = "countries/Hodyntsy.txt"
HOL = "countries/Holland.txt"
HRZ = "countries/Herzegovina.txt"
HSA = "countries/Hansa.txt"
HSC = "countries/Highlands.txt"
HSE = "countries/Hsenwi.txt"
HSI = "countries/Hsipaw.txt"
HSK = "countries/Hosokawa.txt"
HSN = "countries/Ayyubids.txt"
HST = "countries/Huastec.txt"
HTK = "countries/Hatakeyama.txt"
HUA = "countries/Huai.txt"
HUN = "countries/Hungary.txt"
HUR = "countries/Huron.txt"
HWK = "countries/Hathawekela.txt"
ICE = "countries/Iceland.txt"
ICH = "countries/Ichisi.txt"
ICM = "countries/Ichma.txt"
IDR = "countries/Idar.txt"
IKE = "countries/Ikeda.txt"
ILI = "countries/Illinois.txt"
ILK = "countries/Ilkhanate.txt"
ILL = "countries/Illinewek.txt"
IME = "countries/Imereti.txt"
IMG = "countries/Imagawa.txt"
INC = "countries/Inca.txt"
IND = "countries/Indrapura.txt"
ING = "countries/Ingolstadt.txt"
INN = "countries/Innu.txt"
IRE = "countries/Ireland.txt"
IRO = "countries/Iroquois.txt"
IRQ = "countries/Iraq.txt"
ISF = "countries/Isfahan.txt"
ISK = "countries/Isshiki.txt"
ISL = "countries/Isleta.txt"
ITA = "countries/Italy.txt"
ITO = "countries/Ito.txt"
ITZ = "countries/Itza.txt"
JAI = "countries/Malta.txt"
JAJ = "countries/Janjira.txt"
JAN = "countries/Jangladesh.txt"
JAP = "countries/Japan.txt"
JAR = "countries/Jarai.txt"
JFN = "countries/Jaffna.txt"
JGD = "countries/Junagarh.txt"
JIM = "countries/Jima.txt"
JIN = "countries/Jin.txt"
JJI = "countries/Janjero.txt"
JLV = "countries/Jhalavad.txt"
JMB = "countries/Jambi.txt"
JML = "countries/Jumla.txt"
JMN = "countries/Jan Mayen.txt"
JNN = "countries/Jenne.txt"
JNP = "countries/Jaunpur.txt"
JOA = "countries/Joara.txt"
JOH = "countries/Johor.txt"
JOL = "countries/Jolof.txt"
JPR = "countries/Jeypore.txt"
JSL = "countries/Jaisalmer.txt"
KAA = "countries/Kauai.txt"
KAC = "countries/Kachar.txt"
KAF = "countries/Kaffa.txt"
KAL = "countries/Kale.txt"
KAM = "countries/Mdokhams.txt"
KAN = "countries/Kano.txt"
KAQ = "countries/Kaqchikel.txt"
KAR = "countries/Karaman.txt"
KAS = "countries/Yarkand.txt"
KAT = "countries/Kathiawar.txt"
KAU = "countries/Kaurna.txt"
KAZ = "countries/Kazan.txt"
KBA = "countries/Kabylia.txt"
KBO = "countries/KanemBornu.txt"
KBU = "countries/Kaabu.txt"
KED = "countries/Kedah.txt"
KEL = "countries/Kelantan.txt"
KER = "countries/Keres.txt"
KGR = "countries/Kangra.txt"
KHA = "countries/MongolKhanate.txt"
KHD = "countries/Khandesh.txt"
KHI = "countries/Khiva.txt"
KHM = "countries/Khmer.txt"
KHO = "countries/Khorasan.txt"
KIC = "countries/Kiche.txt"
KID = "countries/Kildare.txt"
KIE = "countries/Kiev.txt"
KIK = "countries/Kikondja.txt"
KIO = "countries/Kiowa.txt"
KIT = "countries/Kitara.txt"
KJH = "countries/Keonhjar.txt"
KKC = "countries/Kikuchi.txt"
KLD = "countries/Kalundwe.txt"
KLE = "countries/Kleves.txt"
KLH = "countries/Kalahandi.txt"
KLK = "countries/Khalkha.txt"
KLM = "countries/Kalmyk.txt"
KLN = "countries/Keladi.txt"
KLP = "countries/Kalpi.txt"
KLT = "countries/Kolathunad.txt"
KMC = "countries/Kamchadals.txt"
KMN = "countries/Kumaon.txt"
KMT = "countries/Koch.txt"
KND = "countries/Kandy.txt"
KNG = "countries/Kong.txt"
KNI = "countries/Knights.txt"
KNO = "countries/Kono.txt"
KNZ = "countries/Konstanz.txt"
KOC = "countries/Kochin.txt"
KOH = "countries/Koho.txt"
KOI = "countries/Mann.txt"
KOJ = "countries/Jerusalem.txt"
KOK = "countries/Kokkand.txt"
KOL = "countries/Cologne.txt"
KON = "countries/Kongo.txt"
KOR = "countries/Korea.txt"
KRA = "countries/Krakow.txt"
KRC = "countries/Khorchin.txt"
KRK = "countries/Carnatic.txt"
KRL = "countries/Karelia.txt"
KRM = "countries/Kerman.txt"
KRW = "countries/Karagwe.txt"
KRY = "countries/Gilan.txt"
KSD = "countries/Khoshuud.txt"
KSH = "countries/Kashmir.txt"
KSI = "countries/Kasihta.txt"
KSJ = "countries/Kasanje.txt"
KSK = "countries/Kaskaskia.txt"
KSP = "countries/Kispoko.txt"
KTB = "countries/Kitabatake.txt"
KTS = "countries/Katsina.txt"
KTU = "countries/Kathmandu.txt"
KUB = "countries/Kuba.txt"
KUL = "countries/Kulin.txt"
KUR = "countries/Kurland.txt"
KUT = "countries/Kutai.txt"
KZB = "countries/Kazembe.txt"
KZH = "countries/Kazakh.txt"
LAC = "countries/Lacandon.txt"
LAI = "countries/Lau.txt"
LAK = "countries/Lakota.txt"
LAN = "countries/Florence.txt"
LAP = "countries/LaPlata.txt"
LAR = "countries/Larrakia.txt"
LAU = "countries/Lauenburg.txt"
LBV = "countries/Landshut.txt"
LDK = "countries/Ladakh.txt"
LDU = "countries/Lundu.txt"
LEB = "countries/Lebanon.txt"
LEI = "countries/Leinster.txt"
LEN = "countries/Lenape.txt"
LFA = "countries/Lanfang.txt"
LIB = "countries/Libertatia.txt"
LIE = "countries/Liege.txt"
LIG = "countries/Ligor.txt"
LIP = "countries/Lipan.txt"
LIT = "countries/Lithuania.txt"
LIV = "countries/LivonianOrder.txt"
LNA = "countries/LanNa.txt"
LND = "countries/Lunda.txt"
LNG = "countries/Liang.txt"
LNO = "countries/Lanao.txt"
LOA = "countries/Loango.txt"
LOI = "countries/TheIsles.txt"
LON = "countries/Leon.txt"
LOR = "countries/Lorraine.txt"
LOT = "countries/Lotharingia.txt"
LOU = "countries/Louisiana.txt"
LPP = "countries/Lippe.txt"
LRI = "countries/Luristan.txt"
LUA = "countries/LuangPrabang.txt"
LUB = "countries/Luba.txt"
LUC = "countries/Lucca.txt"
LUN = "countries/Luneburg.txt"
LUW = "countries/Luwu.txt"
LUX = "countries/Luxembourg.txt"
LVA = "countries/Livonia.txt"
LWA = "countries/Limbuwan.txt"
LXA = "countries/LanXang.txt"
MAA = "countries/Mataatua.txt"
MAB = "countries/Malabar.txt"
MAD = "countries/Madurai.txt"
MAE = "countries/Maeda.txt"
MAG = "countries/Magdeburg.txt"
MAH = "countries/Mahican.txt"
MAI = "countries/Mainz.txt"
MAJ = "countries/Majapahit.txt"
MAK = "countries/Makuria.txt"
MAL = "countries/Mali.txt"
MAM = "countries/Burgi.txt"
MAN = "countries/Mantua.txt"
MAR = "countries/Marathas.txt"
MAS = "countries/Madyaas.txt"
MAT = "countries/Matlatzinca.txt"
MAU = "countries/Maui.txt"
MAW = "countries/Marwar.txt"
MAY = "countries/Maya.txt"
MAZ = "countries/Mazovia.txt"
MBA = "countries/Mombasa.txt"
MBL = "countries/Bishnupur.txt"
MBZ = "countries/Montfort-Bregenz.txt"
MCA = "countries/Muisca.txt"
MCH = "countries/Manchu.txt"
MCM = "countries/MacCarthy.txt"
MDA = "countries/Medina.txt"
MDI = "countries/Mogadishu.txt"
MED = "countries/Medri Bahri.txt"
MEI = "countries/Meissen.txt"
MEM = "countries/Memmingen.txt"
MEN = "countries/Mentese.txt"
MER = "countries/Mewar.txt"
MEW = "countries/Mewat.txt"
MEX = "countries/Mexico.txt"
MFA = "countries/Montferrat.txt"
MFL = "countries/Mikhlaf.txt"
MFY = "countries/Mahafaly.txt"
MGD = "countries/Maguindanao.txt"
MGE = "countries/MongolEmpire.txt"
MGR = "countries/Maregh.txt"
MHR = "countries/Mahra.txt"
MHX = "countries/Haixi.txt"
MIA = "countries/Mianjin.txt"
MIK = "countries/Mikmaq.txt"
MIN = "countries/Min.txt"
MIR = "countries/Merina.txt"
MIS = "countries/Miskito.txt"
MIX = "countries/Mixtec.txt"
MJE = "countries/Majeerteen.txt"
MJO = "countries/Majorca.txt"
MJZ = "countries/Jianzhou.txt"
MKA = "countries/MongKawng.txt"
MKL = "countries/Mecklenburg.txt"
MKP = "countries/Makwanpur.txt"
MKS = "countries/Makassar.txt"
MKU = "countries/Makua.txt"
MLB = "countries/Manipur.txt"
MLC = "countries/Malacca.txt"
MLG = "countries/Malagana.txt"
MLH = "countries/Mulhouse.txt"
MLI = "countries/Malindi.txt"
MLK = "countries/Kashen.txt"
MLO = "countries/Milan.txt"
MLS = "countries/Maliseet.txt"
MLW = "countries/Malwa.txt"
MMA = "countries/MongMao.txt"
MMI = "countries/Miami.txt"
MNA = "countries/Maynila.txt"
MNG = "countries/Ming.txt"
MNI = "countries/MongNai.txt"
MNS = "countries/IRE_Munster.txt"
MOD = "countries/Modena.txt"
MOE = "countries/Morea.txt"
MOH = "countries/Mohawk.txt"
MOL = "countries/Moldavia.txt"
MON = "countries/Montenegro.txt"
MOR = "countries/Morocco.txt"
MOS = "countries/Muscowy.txt"
MPA = "countries/MongPai.txt"
MPC = "countries/Mapuche.txt"
MPH = "countries/MuanPhuang.txt"
MRA = "countries/Maravi.txt"
MRE = "countries/Marehan.txt"
MRI = "countries/Mori.txt"
MRK = "countries/Marrakesh.txt"
MSA = "countries/Malaya.txt"
MSC = "countries/Mescalero.txt"
MSG = "countries/Mississage.txt"
MSI = "countries/Mossi.txt"
MSY = "countries/Mushashaiyyah.txt"
MTH = "countries/Meath.txt"
MTR = "countries/Mataram.txt"
MUG = "countries/Mughal.txt"
MUL = "countries/Multan.txt"
MUN = "countries/Munster.txt"
MVA = "countries/Moravia.txt"
MYA = "countries/MongYang.txt"
MYR = "countries/Yeren.txt"
MYS = "countries/Mysore.txt"
MZB = "countries/Mzab.txt"
NAG = "countries/Nagpur.txt"
NAH = "countries/Navajo.txt"
NAJ = "countries/Najd.txt"
NAK = "countries/Nakawe.txt"
NAP = "countries/Naples.txt"
NAT = "countries/Natives.txt"
NAV = "countries/Navarra.txt"
NAX = "countries/Naxos.txt"
NBI = "countries/Nubia.txt"
NDO = "countries/Ndongo.txt"
NED = "countries/Netherlands.txt"
NEH = "countries/Nehiyaw.txt"
NEV = "countries/Nevers.txt"
NGA = "countries/Nagaur.txt"
NGP = "countries/Jharkhand.txt"
NHX = "countries/NorthHaixi.txt"
NJR = "countries/Najran.txt"
NKO = "countries/Nkore.txt"
NNG = "countries/Ning.txt"
NOG = "countries/Nogai.txt"
NOL = "countries/Northumberland.txt"
NOO = "countries/Noongar.txt"
NOR = "countries/Norway.txt"
NOV = "countries/Novgorod.txt"
NPL = "countries/Nepal.txt"
NRM = "countries/Normandy.txt"
NSA = "countries/Nassau.txt"
NSS = "countries/New Providence.txt"
NTC = "countries/Natchitoches.txt"
NTZ = "countries/Natchez.txt"
NUB = "countries/Funj.txt"
NUM = "countries/Nuremberg.txt"
NUP = "countries/Nupe.txt"
NVK = "countries/Nivkh.txt"
NVR = "countries/Navanagar.txt"
NZH = "countries/NizhnyNovgorod.txt"
NZL = "countries/Zealandia.txt"
OAH = "countries/Oahu.txt"
ODA = "countries/Oda.txt"
ODH = "countries/Oudh.txt"
OEO = "countries/Oneota.txt"
OGD = "countries/Ogaadeen.txt"
OGS = "countries/Ogasawara.txt"
OHK = "countries/Ohkay Owingeh.txt"
OIR = "countries/OiratHorde.txt"
OJI = "countries/Ojibwa.txt"
OKA = "countries/Oka.txt"
OLD = "countries/Oldenburg.txt"
OMA = "countries/Oman.txt"
ONE = "countries/Oneida.txt"
ONO = "countries/Onondaga.txt"
OPL = "countries/Opole.txt"
ORD = "countries/Ormond.txt"
ORI = "countries/Orissa.txt"
ORL = "countries/Orleans.txt"
ORM = "countries/Ormuz.txt"
OSA = "countries/Osage.txt"
OSH = "countries/Osheaga.txt"
OSN = "countries/Osnabruck.txt"
OTM = "countries/Otomo.txt"
OTO = "countries/Otomi.txt"
OTT = "countries/Ottawa.txt"
OUC = "countries/Ouchi.txt"
OYO = "countries/Oyo.txt"
PAD = "countries/Paderborn.txt"
PAH = "countries/Pahang.txt"
PAL = "countries/Palatinate.txt"
PAN = "countries/Panna.txt"
PAP = "countries/Papal.txt"
PAR = "countries/Parma.txt"
PAT = "countries/Pattani.txt"
PAW = "countries/Pawnee.txt"
PCH = "countries/Pacaha.txt"
PCJ = "countries/Pacajes.txt"
PDV = "countries/Padova.txt"
PEG = "countries/Pegu.txt"
PEN = "countries/Penobscot.txt"
PEO = "countries/Peoria.txt"
PEQ = "countries/Pequot.txt"
PER = "countries/Persia.txt"
PEU = "countries/Peru.txt"
PGA = "countries/Perugia.txt"
PGR = "countries/Pagarruyung.txt"
PGS = "countries/Pangasinan.txt"
PHA = "countries/Phagmodrupa.txt"
PIC = "countries/Picardy.txt"
PIM = "countries/Pima.txt"
PIR = "countries/Pirates.txt"
PIS = "countries/Pisa.txt"
PLB = "countries/Palembang.txt"
PLC = "countries/TheCommonwealth.txt"
PLT = "countries/Polotsk.txt"
PLW = "countries/Palawa.txt"
POL = "countries/Poland.txt"
POM = "countries/Pommerania.txt"
POR = "countries/Portugal.txt"
POT = "countries/Potawatomi.txt"
POW = "countries/Powhatan.txt"
PRB = "countries/Porbandar.txt"
PRD = "countries/Parlakhimidi.txt"
PRG = "countries/Paraguay.txt"
PRK = "countries/Perak.txt"
PRM = "countries/Perm.txt"
PRO = "countries/Provence.txt"
PRU = "countries/Prussia.txt"
PRY = "countries/Port Royal.txt"
PSA = "countries/Pasai.txt"
PSK = "countries/Pskov.txt"
PSS = "countries/Passau.txt"
PTA = "countries/Patiala.txt"
PTE = "countries/Pate.txt"
PTG = "countries/Potiguara.txt"
PTL = "countries/Palitana.txt"
PTT = "countries/Patna.txt"
PUE = "countries/Pueblo.txt"
PUN = "countries/Punjab.txt"
QAR = "countries/QaraKoyunlu.txt"
QAS = "countries/QasimKhanate.txt"
QIC = "countries/Qi.txt"
QIN = "countries/Qin.txt"
QNG = "countries/Qing.txt"
QOM = "countries/Qom.txt"
QTO = "countries/Quito.txt"
QUE = "countries/Quebec.txt"
QUI = "countries/Quizquiz.txt"
RAG = "countries/Ragusa.txt"
RAM = "countries/Ramazan.txt"
RAS = "countries/Rassids.txt"
REG = "countries/Regensburg.txt"
RFR = "countries/Nanbu.txt"
RHA = "countries/Rhade.txt"
RIG = "countries/Riga.txt"
RJK = "countries/Rajkot.txt"
RJP = "countries/Rajputana.txt"
RMN = "countries/Romania.txt"
RMP = "countries/Rohilkandh.txt"
ROM = "countries/RomanEmpire.txt"
ROT = "countries/Rothenburg.txt"
RSO = "countries/Rostov.txt"
RTT = "countries/Ratanpur.txt"
RUG = "countries/Rugen.txt"
RUM = "countries/Rum.txt"
RUP = "countries/Ruppin.txt"
RUS = "countries/Russia.txt"
RVA = "countries/Ravensburg.txt"
RWA = "countries/Rwanda.txt"
RYA = "countries/Ryazan.txt"
RYU = "countries/Ryukyu.txt"
RZI = "countries/Rozwi.txt"
RZW = "countries/Butua.txt"
SAK = "countries/Siak.txt"
SAL = "countries/Salish.txt"
SAM = "countries/Samoa.txt"
SAR = "countries/Sardinia.txt"
SAT = "countries/Satapo.txt"
SAV = "countries/Savoy.txt"
SAX = "countries/Saxony.txt"
SBA = "countries/Shiba.txt"
SBP = "countries/Sambalpur.txt"
SCA = "countries/Scandinavia.txt"
SCO = "countries/Scotland.txt"
SDY = "countries/Sadiya.txt"
SEN = "countries/Seneca.txt"
SER = "countries/Serbia.txt"
SFA = "countries/SofalaSwa.txt"
SHA = "countries/Shawnee.txt"
SHL = "countries/Holstein.txt"
SHM = "countries/Shammar.txt"
SHN = "countries/Shoni.txt"
SHO = "countries/Shoshone.txt"
SHR = "countries/Sharjah.txt"
SHU = "countries/Shu.txt"
SHY = "countries/Shaybanid.txt"
SIA = "countries/Siam.txt"
SIB = "countries/Sibir.txt"
SIC = "countries/Sicily.txt"
SIE = "countries/Siena.txt"
SIL = "countries/Silesia.txt"
SIO = "countries/Sioux.txt"
SIS = "countries/Sistan.txt"
SKA = "countries/Sakalava.txt"
SKK = "countries/Sikkim.txt"
SLE = "countries/Sale.txt"
SLN = "countries/Sligo.txt"
SLO = "countries/Slovakia.txt"
SLZ = "countries/Salzburg.txt"
SMB = "countries/Sambas.txt"
SME = "countries/Samtskhe.txt"
SMI = "countries/Sami.txt"
SMO = "countries/Smolensk.txt"
SMZ = "countries/Shimazu.txt"
SNA = "countries/Sonora.txt"
SND = "countries/Sind.txt"
SOA = "countries/Shewa.txt"
SOF = "countries/Sofala.txt"
SOK = "countries/Sokoto.txt"
SOL = "countries/Solon.txt"
SOM = "countries/Somalia.txt"
SON = "countries/Songhai.txt"
SOO = "countries/So.txt"
SOR = "countries/Sorbia.txt"
SOS = "countries/Sus.txt"
SPA = "countries/Spain.txt"
SPI = "countries/SardiniaPiedmont.txt"
SPL = "countries/Spoleto.txt"
SRG = "countries/Surguja.txt"
SRH = "countries/Sirhind.txt"
SRM = "countries/Sirmur.txt"
SRU = "countries/Saruhan.txt"
SRV = "countries/Shirvanshah.txt"
SST = "countries/Shan.txt"
STA = "countries/Stadacona.txt"
STE = "countries/Stettin.txt"
STK = "countries/Satake.txt"
STY = "countries/Styria.txt"
SUK = "countries/Sukhothai.txt"
SUL = "countries/Sulu.txt"
SUN = "countries/Sunda.txt"
SUS = "countries/Susquehannock.txt"
SWA = "countries/Swabia.txt"
SWE = "countries/Sweden.txt"
SWI = "countries/Schweiz.txt"
SYG = "countries/Sarigyogir.txt"
SYN = "countries/Synthetics.txt"
SYO = "countries/Soyo.txt"
SYR = "countries/Syria.txt"
SZO = "countries/Saluzzo.txt"
TAB = "countries/Tabarestan.txt"
TAH = "countries/Tahontaenrat.txt"
TAI = "countries/Tairona.txt"
TAK = "countries/Takitimu.txt"
TAN = "countries/Tainui.txt"
TAR = "countries/Tarascan.txt"
TAU = "countries/Taungu.txt"
TBK = "countries/Tumbuka.txt"
TBR = "countries/Tabriz.txt"
TDO = "countries/Tondo.txt"
TEA = "countries/TeArawa.txt"
TEN = "countries/Tenkodogo.txt"
TEO = "countries/Teotitlan.txt"
TER = "countries/Ternate.txt"
TET = "countries/Tetouan.txt"
TEU = "countries/Teutonicorder.txt"
TEX = "countries/Texas.txt"
TFL = "countries/Tafilalt.txt"
TGT = "countries/Touggourt.txt"
THU = "countries/Thuringia.txt"
TIB = "countries/Tibet.txt"
TID = "countries/Tidore.txt"
TIM = "countries/Timurid.txt"
TIO = "countries/Tionontate.txt"
TIR = "countries/Tirol.txt"
TIW = "countries/Tiwi.txt"
TKD = "countries/Takeda.txt"
TKG = "countries/Tokugawa.txt"
TKI = "countries/Toki.txt"
TLA = "countries/Tlapanec.txt"
TLC = "countries/Tlemcen.txt"
TLG = "countries/Telingana.txt"
TLX = "countries/Tlaxcala.txt"
TMB = "countries/Timbuktu.txt"
TNG = "countries/Tang.txt"
TNJ = "countries/Tanjore.txt"
TNK = "countries/Taranaki.txt"
TNT = "countries/Trent.txt"
TOG = "countries/Tonga.txt"
TOK = "countries/Tonkin.txt"
TON = "countries/Tonallan.txt"
TOR = "countries/Tortuga.txt"
TOT = "countries/Totonac.txt"
TOU = "countries/Toulouse.txt"
TPA = "countries/Tupinamba.txt"
TPQ = "countries/Tupiniquim.txt"
TPR = "countries/Tripura.txt"
TRA = "countries/Transylvania.txt"
TRE = "countries/Trebizond.txt"
TRI = "countries/Trier.txt"
TRP = "countries/Tripoli.txt"
TRS = "countries/Transoxiana.txt"
TRT = "countries/Tirhut.txt"
TRY = "countries/Tyrconnell.txt"
TSC = "countries/Tuscarora.txt"
TTI = "countries/Tsutsui.txt"
TTL = "countries/Three Leagues.txt"
TTS = "countries/Two Sicilies.txt"
TTT = "countries/TeTaiTokerau.txt"
TUA = "countries/Tapuia.txt"
TUN = "countries/Tunisia.txt"
TUR = "countries/Ottomans.txt"
TUS = "countries/Tuscany.txt"
TVE = "countries/Tver.txt"
TYO = "countries/Tyo.txt"
TYR = "countries/Tyrone.txt"
UBH = "countries/Buha.txt"
UBV = "countries/Munich.txt"
UES = "countries/Uesugi.txt"
UHW = "countries/HawaiiUnited.txt"
UKR = "countries/Ukraine.txt"
ULM = "countries/Ulm.txt"
ULS = "countries/Ulster.txt"
URB = "countries/Urbino.txt"
USA = "countries/USA.txt"
UTN = "countries/Utsunomiya.txt"
UTR = "countries/Utrecht.txt"
UTS = "countries/Utsang.txt"
VAL = "countries/Valencia.txt"
VEN = "countries/Venice.txt"
VER = "countries/Verden.txt"
VIE = "countries/Vientiane.txt"
VIJ = "countries/Vijaynagara.txt"
VIL = "countries/Viti Levu.txt"
VIT = "countries/Viti.txt"
VND = "countries/Venad.txt"
VNL = "countries/Vanua Levu.txt"
VNZ = "countries/Venezuela.txt"
VOL = "countries/Volyn.txt"
VRM = "countries/Vermont.txt"
VRN = "countries/Verona.txt"
W00 = "countries/c_sosva.txt"
W01 = "countries/c_south_kordofan.txt"
W02 = "countries/c_spreewald.txt"
W03 = "countries/c_sravasti.txt"
W04 = "countries/c_stezycka.txt"
W05 = "countries/c_suakin.txt"
W06 = "countries/c_subay.txt"
W07 = "countries/c_sudurland.txt"
W08 = "countries/c_sugbu.txt"
W09 = "countries/c_suizhou_china.txt"
W0A = "countries/c_suizhou_dongchuan_china.txt"
W0B = "countries/c_suizhou_xia_china.txt"
W0C = "countries/c_sula.txt"
W0D = "countries/c_suligaw.txt"
W0E = "countries/c_sumalata.txt"
W0F = "countries/c_sumbur_barito.txt"
W0G = "countries/c_sumozhou_china.txt"
W0H = "countries/c_suondavara.txt"
W0I = "countries/c_suzdal.txt"
W0J = "countries/c_suzhou_wu_china.txt"
W0K = "countries/c_suzhou_xu_china.txt"
W0L = "countries/c_swa.txt"
W0M = "countries/c_syriam.txt"
W0N = "countries/c_sysma.txt"
W0O = "countries/c_ta_veang.txt"
W0P = "countries/c_tabary.txt"
W0Q = "countries/c_tadjoura.txt"
W0R = "countries/c_tadmekka.txt"
W0S = "countries/c_taghaza.txt"
W0T = "countries/c_tahoua.txt"
W0U = "countries/c_taif.txt"
W0V = "countries/c_taishan_china.txt"
W0W = "countries/c_taiyuan_china.txt"
W0X = "countries/c_taizhou_china.txt"
W0Y = "countries/c_takajung.txt"
W0Z = "countries/c_takao.txt"
W10 = "countries/c_takkeda.txt"
W11 = "countries/c_tamasna.txt"
W12 = "countries/c_tambrauw.txt"
W13 = "countries/c_tamentit.txt"
W14 = "countries/c_tamiso.txt"
W15 = "countries/c_tanah_bumbu.txt"
W16 = "countries/c_tanangsi.txt"
W17 = "countries/c_tanghay.txt"
W18 = "countries/c_tangway.txt"
W19 = "countries/c_tangzhou_chu_china.txt"
W1A = "countries/c_tanjungpura.txt"
W1B = "countries/c_tara.txt"
W1C = "countries/c_tarakan.txt"
W1D = "countries/c_targyl.txt"
W1E = "countries/c_tarnowska.txt"
W1F = "countries/c_tarqan_china.txt"
W1G = "countries/c_tartas_SIB.txt"
W1H = "countries/c_tavasts.txt"
W1I = "countries/c_tawau.txt"
W1J = "countries/c_tayabas.txt"
W1K = "countries/c_tayapura.txt"
W1L = "countries/c_taytay.txt"
W1M = "countries/c_tboli.txt"
W1N = "countries/c_teke.txt"
W1O = "countries/c_telemark.txt"
W1P = "countries/c_teli_china.txt"
W1Q = "countries/c_temne.txt"
W1R = "countries/c_temo.txt"
W1S = "countries/c_ter.txt"
W1T = "countries/c_terebovl.txt"
W1U = "countries/c_teriqan_china.txt"
W1V = "countries/c_tessalit.txt"
W1W = "countries/c_thaungdut.txt"
W1X = "countries/c_thuy_vi.txt"
W1Y = "countries/c_tiandejun_china.txt"
W1Z = "countries/c_tianshui_china.txt"
W20 = "countries/c_tiayban.txt"
W21 = "countries/c_tibesti.txt"
W22 = "countries/c_timbi.txt"
W23 = "countries/c_tinanggea.txt"
W24 = "countries/c_tindouf.txt"
W25 = "countries/c_tingzhou_min_china.txt"
W26 = "countries/c_tinombo.txt"
W27 = "countries/c_toba.txt"
W28 = "countries/c_tobol.txt"
W29 = "countries/c_todo.txt"
W2A = "countries/c_togean_island.txt"
W2B = "countries/c_tokumbay.txt"
W2C = "countries/c_tolitoli.txt"
W2D = "countries/c_toma.txt"
W2E = "countries/c_tomborungan.txt"
W2F = "countries/c_tomohon.txt"
W2G = "countries/c_tondano.txt"
W2H = "countries/c_tongguan_china.txt"
W2I = "countries/c_tongzhou_bohai_china.txt"
W2J = "countries/c_tongzhou_pingyi_china.txt"
W2K = "countries/c_topoyo.txt"
W2L = "countries/c_toraja.txt"
W2M = "countries/c_torne.txt"
W2N = "countries/c_toro.txt"
W2O = "countries/c_tortoli.txt"
W2P = "countries/c_torun.txt"
W2Q = "countries/c_totma.txt"
W2R = "countries/c_touat.txt"
W2S = "countries/c_tra_lan.txt"
W2T = "countries/c_trandheim.txt"
W2U = "countries/c_travunia.txt"
W2V = "countries/c_tu_long.txt"
W2W = "countries/c_tudgha.txt"
W2X = "countries/c_tulay.txt"
W2Y = "countries/c_tulun.txt"
W2Z = "countries/c_tumak.txt"
W30 = "countries/c_tung_lang.txt"
W31 = "countries/c_tunjung.txt"
W32 = "countries/c_tuyen_quang.txt"
W33 = "countries/c_tyendugu.txt"
W34 = "countries/c_tyumen.txt"
W35 = "countries/c_udger_china.txt"
W36 = "countries/c_udgur_china.txt"
W37 = "countries/c_ufa.txt"
W38 = "countries/c_uiska.txt"
W39 = "countries/c_ulch_china.txt"
W3A = "countries/c_uliuty.txt"
W3B = "countries/c_umiai.txt"
W3C = "countries/c_unayan.txt"
W3D = "countries/c_upper_bono.txt"
W3E = "countries/c_upper_gurma.txt"
W3F = "countries/c_uraltau.txt"
W3G = "countries/c_urd_china.txt"
W3H = "countries/c_uroghu_china.txt"
W3I = "countries/c_ushytsia.txt"
W3J = "countries/c_ustyug.txt"
W3K = "countries/c_uthomporn.txt"
W3L = "countries/c_utiri_pale.txt"
W3M = "countries/c_uulynkhol.txt"
W3N = "countries/c_uzgend_KARA.txt"
W3O = "countries/c_van_ban.txt"
W3P = "countries/c_vargashi.txt"
W3Q = "countries/c_varmland.txt"
W3R = "countries/c_vastvag.txt"
W3S = "countries/c_vasyugan.txt"
W3T = "countries/c_velsk.txt"
W3U = "countries/c_vestfold.txt"
W3V = "countries/c_vestisland.txt"
W3W = "countries/c_viengthong.txt"
W3X = "countries/c_viet_thuong.txt"
W3Y = "countries/c_viipuri.txt"
W3Z = "countries/c_vingulmork.txt"
W40 = "countries/c_visnupura_vn.txt"
W41 = "countries/c_vitim.txt"
W42 = "countries/c_vladimir.txt"
W43 = "countries/c_vodi.txt"
W44 = "countries/c_volkovysk.txt"
W45 = "countries/c_volodymyr.txt"
W46 = "countries/c_vologda.txt"
W47 = "countries/c_vunsanh.txt"
W48 = "countries/c_waigama.txt"
W49 = "countries/c_waigeo.txt"
W4A = "countries/c_waj.txt"
W4B = "countries/c_wakatobi.txt"
W4C = "countries/c_wamesa.txt"
W4D = "countries/c_wananzhou.txt"
W4E = "countries/c_wandala.txt"
W4F = "countries/c_wang_saphung.txt"
W4G = "countries/c_wanzhou_china.txt"
W4H = "countries/c_wasile.txt"
W4I = "countries/c_wassa.txt"
W4J = "countries/c_watampone.txt"
W4K = "countries/c_weizhou_china.txt"
W4L = "countries/c_weizhou_ji_china.txt"
W4M = "countries/c_weizhou_longxi_china.txt"
W4N = "countries/c_wejewa.txt"
W4O = "countries/c_wellega.txt"
W4P = "countries/c_wenyon.txt"
W4Q = "countries/c_wenzhou_yue_china.txt"
W4R = "countries/c_werle.txt"
W4S = "countries/c_west_kordofan.txt"
W4T = "countries/c_wetar.txt"
W4U = "countries/c_wielunska.txt"
W4V = "countries/c_wirabhumi.txt"
W4W = "countries/c_worodugu.txt"
W4X = "countries/c_wowoni.txt"
W4Y = "countries/c_wudu_china.txt"
W4Z = "countries/c_wugong_china.txt"
W50 = "countries/c_wuhou_china.txt"
W51 = "countries/c_wuli.txt"
W52 = "countries/c_wulv_china.txt"
W53 = "countries/c_wuzhou_yue_china.txt"
W54 = "countries/c_xaisomboun.txt"
W55 = "countries/c_xiangfan_china.txt"
W56 = "countries/c_xiangkhouang.txt"
W57 = "countries/c_xiangzhou_china.txt"
W58 = "countries/c_xianyang_china.txt"
W59 = "countries/c_xianzhou_sumo_china.txt"
W5A = "countries/c_xiazhou_china.txt"
W5B = "countries/c_xiazhou_chu_china.txt"
W5C = "countries/c_xingzhou_china.txt"
W5D = "countries/c_xingzhou_hanzhong_china.txt"
W5E = "countries/c_xinhui_china.txt"
W5F = "countries/c_xinzhou_dai_china.txt"
W5G = "countries/c_xinzhou_wu_china.txt"
W5H = "countries/c_xizhou_dongchuan_china.txt"
W5I = "countries/c_xizhou_hezhong_china.txt"
W5J = "countries/c_xizhou_qian_china.txt"
W5K = "countries/c_xuandezhou_china.txt"
W5L = "countries/c_xuanzhou_china.txt"
W5M = "countries/c_xunzhou_china.txt"
W5N = "countries/c_xuuzhou_china.txt"
W5O = "countries/c_xuzhou_xu_china.txt"
W5P = "countries/c_yaeyama_china.txt"
W5Q = "countries/c_yalu_china.txt"
W5R = "countries/c_yamdena.txt"
W5S = "countries/c_yamethin.txt"
W5T = "countries/c_yangzhou_china.txt"
W5U = "countries/c_yangzhou_hanzhong_china.txt"
W5V = "countries/c_yanjin.txt"
W5W = "countries/c_yanokul.txt"
W5X = "countries/c_yanzhou_china.txt"
W5Y = "countries/c_yanzhou_shuofang_china.txt"
W5Z = "countries/c_yanzhou_xia_china.txt"
W60 = "countries/c_yaohan_china.txt"
W61 = "countries/c_yar-calli.txt"
W62 = "countries/c_yatvyagi.txt"
W63 = "countries/c_yauri.txt"
W64 = "countries/c_yawnghwe.txt"
W65 = "countries/c_yazhou.txt"
W66 = "countries/c_yazhou_china.txt"
W67 = "countries/c_yekaterinburg.txt"
W68 = "countries/c_yen_lo.txt"
W69 = "countries/c_yen_moc.txt"
W6A = "countries/c_yenisei.txt"
W6B = "countries/c_yichuan_china.txt"
W6C = "countries/c_yikun_china.txt"
W6D = "countries/c_yingzhou_chu_china.txt"
W6E = "countries/c_yingzhou_ji_china.txt"
W6F = "countries/c_yingzhou_jin_china.txt"
W6G = "countries/c_yingzhou_song_china.txt"
W6H = "countries/c_yinzhou_china.txt"
W6I = "countries/c_yizhou_hedong_china.txt"
W6J = "countries/c_yizhou_taining_china.txt"
W6K = "countries/c_yizhou_yan_china.txt"
W6L = "countries/c_yongzhou_hunan_china.txt"
W6M = "countries/c_yoshkar-ola.txt"
W6N = "countries/c_youzhou_china.txt"
W6O = "countries/c_youzhou_shuofang_china.txt"
W6P = "countries/c_yuanzhou_jiangxi_china.txt"
W6Q = "countries/c_yuanzou_xia_china.txt"
W6R = "countries/c_yuezhou_chu_china.txt"
W6S = "countries/c_yuezhou_yue_china.txt"
W6T = "countries/c_yulinzhou_china.txt"
W6U = "countries/c_yunzhou_china.txt"
W6V = "countries/c_yunzhou_liang_china.txt"
W6W = "countries/c_yuzhou_ba_china.txt"
W6X = "countries/c_yuzhou_dai_china.txt"
W6Y = "countries/c_zachlumia.txt"
W6Z = "countries/c_zakroczymska.txt"
W70 = "countries/c_zammour.txt"
W71 = "countries/c_zardan.txt"
W72 = "countries/c_zarma.txt"
W73 = "countries/c_zaslavl.txt"
W74 = "countries/c_zawila.txt"
W75 = "countries/c_zelengora.txt"
W76 = "countries/c_zezhou_china.txt"
W77 = "countries/c_zhangzhou_min_china.txt"
W78 = "countries/c_zhaozhou_china.txt"
W79 = "countries/c_zhengzhou_china.txt"
W7A = "countries/c_zhenzhou_zhuyajun_china.txt"
W7B = "countries/c_zhongzhou_ba_china.txt"
W7C = "countries/c_zhuangzhou.txt"
W7D = "countries/c_zibo_china.txt"
W7E = "countries/c_zigui_china.txt"
W7F = "countries/c_ziwudao_china.txt"
W7G = "countries/c_ziz.txt"
W7H = "countries/c_zizhou_dongchuan_china.txt"
W7I = "countries/c_zizhou_xichuan_china.txt"
WAD = "countries/Wadai.txt"
WAI = "countries/Waitaha.txt"
WAL = "countries/Wallachia.txt"
WAM = "countries/Wampanoag.txt"
WAR = "countries/Warsangali.txt"
WBG = "countries/Wurzburg.txt"
WCR = "countries/Cree.txt"
WCY = "countries/Wichiyena.txt"
WEN = "countries/Wenro.txt"
WES = "countries/Westfalia.txt"
WGD = "countries/Wagadugu.txt"
WIC = "countries/Wichita.txt"
WKA = "countries/Wanka.txt"
WLS = "countries/Wales.txt"
WLY = "countries/Welayta.txt"
WOL = "countries/Wolgast.txt"
WRU = "countries/Wurundjeri.txt"
WSI = "countries/WestIndies.txt"
WUR = "countries/Wurttemberg.txt"
WUU = "countries/Wu.txt"
X00 = "countries/c_lviv.txt"
X01 = "countries/c_lyubim.txt"
X02 = "countries/c_madeira.txt"
X03 = "countries/c_madura.txt"
X04 = "countries/c_mae_la_noi.txt"
X05 = "countries/c_mae_ramat.txt"
X06 = "countries/c_magwe.txt"
X07 = "countries/c_mahakam.txt"
X08 = "countries/c_mahaparvata.txt"
X09 = "countries/c_mahasay.txt"
X0A = "countries/c_maingmaw.txt"
X0B = "countries/c_mairasi.txt"
X0C = "countries/c_mait.txt"
X0D = "countries/c_mait_ph.txt"
X0E = "countries/c_makasae.txt"
X0F = "countries/c_makhir.txt"
X0G = "countries/c_malakosa.txt"
X0H = "countries/c_malawaken.txt"
X0I = "countries/c_malili.txt"
X0J = "countries/c_malinau.txt"
X0K = "countries/c_malindug.txt"
X0L = "countries/c_mamasa.txt"
X0M = "countries/c_mamburao.txt"
X0N = "countries/c_mamprusi.txt"
X0O = "countries/c_mamuju.txt"
X0P = "countries/c_man.txt"
X0Q = "countries/c_manado.txt"
X0R = "countries/c_manatau.txt"
X0S = "countries/c_mang_lian.txt"
X0T = "countries/c_mangbu.txt"
X0U = "countries/c_manggarai.txt"
X0V = "countries/c_manglai_china.txt"
X0W = "countries/c_manglon.txt"
X0X = "countries/c_mantion.txt"
X0Y = "countries/c_manturovo.txt"
X0Z = "countries/c_mareeg.txt"
X10 = "countries/c_marsabit.txt"
X11 = "countries/c_marsaoleh.txt"
X12 = "countries/c_martyuba.txt"
X13 = "countries/c_masa.txt"
X14 = "countries/c_masalit.txt"
X15 = "countries/c_masbat.txt"
X16 = "countries/c_masinloc.txt"
X17 = "countries/c_masiu.txt"
X18 = "countries/c_masohi.txt"
X19 = "countries/c_mau.txt"
X1A = "countries/c_mawkmai.txt"
X1B = "countries/c_mawlamyine.txt"
X1C = "countries/c_maybrat.txt"
X1D = "countries/c_mayo.txt"
X1E = "countries/c_medelpad.txt"
X1F = "countries/c_meizhou_xichuan_china.txt"
X1G = "countries/c_melanau.txt"
X1H = "countries/c_melhi.txt"
X1I = "countries/c_melilla.txt"
X1J = "countries/c_meng_laa.txt"
X1K = "countries/c_meng_lun.txt"
X1L = "countries/c_mengzhou_china.txt"
X1M = "countries/c_menorca.txt"
X1N = "countries/c_mentawai_islands.txt"
X1O = "countries/c_mianzhou_china.txt"
X1P = "countries/c_miastko.txt"
X1Q = "countries/c_middag.txt"
X1R = "countries/c_midsurrended_china.txt"
X1S = "countries/c_minbu.txt"
X1T = "countries/c_mindat.txt"
X1U = "countries/c_mindon.txt"
X1V = "countries/c_mingin.txt"
X1W = "countries/c_mingzhou_china.txt"
X1X = "countries/c_mingzhou_hebei_china.txt"
X1Y = "countries/c_minolo.txt"
X1Z = "countries/c_minzhou_china.txt"
X20 = "countries/c_miri.txt"
X21 = "countries/c_mizhou_qi_china.txt"
X22 = "countries/c_mnong.txt"
X23 = "countries/c_molibagu.txt"
X24 = "countries/c_mondul_kiri.txt"
X25 = "countries/c_mong_mit.txt"
X26 = "countries/c_mongkung.txt"
X27 = "countries/c_mongnawng.txt"
X28 = "countries/c_mongyang.txt"
X29 = "countries/c_monmouthshire.txt"
X2A = "countries/c_montaigu.txt"
X2B = "countries/c_morarna.txt"
X2C = "countries/c_morong.txt"
X2D = "countries/c_mozhaysk.txt"
X2E = "countries/c_mozhou_china.txt"
X2F = "countries/c_muang_et.txt"
X2G = "countries/c_muang_lay.txt"
X2H = "countries/c_muang_so.txt"
X2I = "countries/c_muang_thaeng.txt"
X2J = "countries/c_muara_wahau.txt"
X2K = "countries/c_mudan_china.txt"
X2L = "countries/c_mudug.txt"
X2M = "countries/c_mukdahan.txt"
X2N = "countries/c_muli.txt"
X2O = "countries/c_muna.txt"
X2P = "countries/c_munda.txt"
X2Q = "countries/c_murin_china.txt"
X2R = "countries/c_mustasaari.txt"
X2S = "countries/c_muzhou_yue_china.txt"
X2T = "countries/c_myataung.txt"
X2U = "countries/c_myedu.txt"
X2V = "countries/c_myeik.txt"
X2W = "countries/c_na_kang.txt"
X2X = "countries/c_nabunturan.txt"
X2Y = "countries/c_naga.txt"
X2Z = "countries/c_naga_hills.txt"
X30 = "countries/c_naga_ph.txt"
X31 = "countries/c_naha_aya.txt"
X32 = "countries/c_nahalin.txt"
X33 = "countries/c_nakkavaram.txt"
X34 = "countries/c_nalu.txt"
X35 = "countries/c_nam_bak.txt"
X36 = "countries/c_nam_tha.txt"
X37 = "countries/c_namandiru.txt"
X38 = "countries/c_namdalfylki.txt"
X39 = "countries/c_namhsan.txt"
X3A = "countries/c_nandana.txt"
X3B = "countries/c_nanhai_china.txt"
X3C = "countries/c_nanhai_okjeo_china.txt"
X3D = "countries/c_nankan.txt"
X3E = "countries/c_nanning_china.txt"
X3F = "countries/c_nanumba.txt"
X3G = "countries/c_nanzheng_china.txt"
X3H = "countries/c_narim.txt"
X3I = "countries/c_natuna.txt"
X3J = "countries/c_naumberg.txt"
X3K = "countries/c_ndenye.txt"
X3L = "countries/c_nedenes.txt"
X3M = "countries/c_nem_china.txt"
X3N = "countries/c_neramkary.txt"
X3O = "countries/c_ngada.txt"
X3P = "countries/c_ngaliyao.txt"
X3Q = "countries/c_nias.txt"
X3R = "countries/c_ningzhou_khitan_china.txt"
X3S = "countries/c_ningzhou_qin_china.txt"
X3T = "countries/c_niomi.txt"
X3U = "countries/c_nivkh_china.txt"
X3V = "countries/c_nong_bua_lam_phu.txt"
X3W = "countries/c_nordmark.txt"
X3X = "countries/c_nordrland.txt"
X3Y = "countries/c_norwegian_more.txt"
X3Z = "countries/c_novogrudok.txt"
X40 = "countries/c_nugaal.txt"
X41 = "countries/c_nuon.txt"
X42 = "countries/c_nurtay.txt"
X43 = "countries/c_nyene.txt"
X44 = "countries/c_nyland.txt"
X45 = "countries/c_nyongbyon_china.txt"
X46 = "countries/c_nzi.txt"
X47 = "countries/c_okangara.txt"
X48 = "countries/c_olavinlinna.txt"
X49 = "countries/c_olkhon.txt"
X4A = "countries/c_ondur_china.txt"
X4B = "countries/c_onega_BJA.txt"
X4C = "countries/c_onon_china.txt"
X4D = "countries/c_onsthia.txt"
X4E = "countries/c_opanda.txt"
X4F = "countries/c_ordos_china.txt"
X4G = "countries/c_orenburg.txt"
X4H = "countries/c_orim_china.txt"
X4I = "countries/c_orkney.txt"
X4J = "countries/c_ormok.txt"
X4K = "countries/c_oudalan.txt"
X4L = "countries/c_oulu.txt"
X4M = "countries/c_pagania.txt"
X4N = "countries/c_pajai.txt"
X4O = "countries/c_pak_beng.txt"
X4P = "countries/c_pakembangan.txt"
X4Q = "countries/c_pakpak.txt"
X4R = "countries/c_palattae.txt"
X4S = "countries/c_palniki.txt"
X4T = "countries/c_palu.txt"
X4U = "countries/c_paluan.txt"
X4V = "countries/c_pamotan.txt"
X4W = "countries/c_panduranga.txt"
X4X = "countries/c_panglao.txt"
X4Y = "countries/c_parepare.txt"
X4Z = "countries/c_pasangkayu.txt"
X50 = "countries/c_paser.txt"
X51 = "countries/c_pashu.txt"
X52 = "countries/c_peaccam.txt"
X53 = "countries/c_pedersore.txt"
X54 = "countries/c_pelym.txt"
X55 = "countries/c_pembrokeshire.txt"
X56 = "countries/c_penglai_china.txt"
X57 = "countries/c_pengluzhou_china.txt"
X58 = "countries/c_pengzhou_china.txt"
X59 = "countries/c_penugonda.txt"
X5A = "countries/c_penur_china.txt"
X5B = "countries/c_peremyshl.txt"
X5C = "countries/c_peresopnytsia.txt"
X5D = "countries/c_petropavl.txt"
X5E = "countries/c_petropavolsk.txt"
X5F = "countries/c_phainam.txt"
X5G = "countries/c_phayuha_khiri.txt"
X5H = "countries/c_phichai.txt"
X5I = "countries/c_phitsanulok.txt"
X5J = "countries/c_pho_pha.txt"
X5K = "countries/c_phra_bang.txt"
X5L = "countries/c_phrae.txt"
X5M = "countries/c_phrao.txt"
X5N = "countries/c_pielinen.txt"
X5O = "countries/c_pila.txt"
X5P = "countries/c_pinagpanaan.txt"
X5Q = "countries/c_pingyi_china.txt"
X5R = "countries/c_pingzhou_china.txt"
X5S = "countries/c_pinsk.txt"
X5T = "countries/c_pipikoro.txt"
X5U = "countries/c_piru.txt"
X5V = "countries/c_plocka.txt"
X5W = "countries/c_plyos.txt"
X5X = "countries/c_poar_china.txt"
X5Y = "countries/c_polewali.txt"
X5Z = "countries/c_polo.txt"
X60 = "countries/c_pomorje.txt"
X61 = "countries/c_poso.txt"
X62 = "countries/c_povenets.txt"
X63 = "countries/c_pozhuo_china.txt"
X64 = "countries/c_pranburi.txt"
X65 = "countries/c_prenzlau.txt"
X66 = "countries/c_prey_nokor.txt"
X67 = "countries/c_pribpri.txt"
X68 = "countries/c_pudozh.txt"
X69 = "countries/c_pulo_tigah.txt"
X6A = "countries/c_putao.txt"
X6B = "countries/c_putussibau.txt"
X6C = "countries/c_puyu_china.txt"
X6D = "countries/c_puzhou_china.txt"
X6E = "countries/c_puzhou_dongchuan_china.txt"
X6F = "countries/c_puzhou_liang_china.txt"
X6G = "countries/c_pyongyang.txt"
X6H = "countries/c_qalaafe.txt"
X6I = "countries/c_qianxi_china.txt"
X6J = "countries/c_qianzhou_jiangxi_china.txt"
X6K = "countries/c_qibingga_china.txt"
X6L = "countries/c_qichun_china.txt"
X6M = "countries/c_qimr.txt"
X6N = "countries/c_qingchengshan_china.txt"
X6O = "countries/c_qingzhou_china.txt"
X6P = "countries/c_qingzhou_qi_china.txt"
X6Q = "countries/c_qinzhou_gui_china.txt"
X6R = "countries/c_qinzhou_hedong_china.txt"
X6S = "countries/c_qiongzhou_china.txt"
X6T = "countries/c_qiuchi_china.txt"
X6U = "countries/c_qizhou_qi_china.txt"
X6V = "countries/c_quanzhou_china.txt"
X6W = "countries/c_quriltay.txt"
X6X = "countries/c_quynh_nhai.txt"
X6Y = "countries/c_quzhou_ba_china.txt"
X6Z = "countries/c_quzhou_china.txt"
X70 = "countries/c_radomska.txt"
X71 = "countries/c_raeng_khoi.txt"
X72 = "countries/c_ramulog.txt"
X73 = "countries/c_raozhou_china.txt"
X74 = "countries/c_ras_hafun.txt"
X75 = "countries/c_renandu.txt"
X76 = "countries/c_rogalandi.txt"
X77 = "countries/c_rongyi_china.txt"
X78 = "countries/c_rongzhou_gui_china.txt"
X79 = "countries/c_rongzhou_xichuan_china.txt"
X7A = "countries/c_roslavl.txt"
X7B = "countries/c_rostock.txt"
X7C = "countries/c_rounala.txt"
X7D = "countries/c_rulai.txt"
X7E = "countries/c_runzhou_china.txt"
X7F = "countries/c_ruzhou_china.txt"
X7G = "countries/c_ryty.txt"
X7H = "countries/c_saalum.txt"
X7I = "countries/c_sabakyul.txt"
X7J = "countries/c_sacz.txt"
X7K = "countries/c_sadan.txt"
X7L = "countries/c_sadenor_china.txt"
X7M = "countries/c_sagiz.txt"
X7N = "countries/c_sakmara.txt"
X7O = "countries/c_salamat.txt"
X7P = "countries/c_salavat.txt"
X7Q = "countries/c_salawati.txt"
X7R = "countries/c_sam_tay.txt"
X7S = "countries/c_samar_VB.txt"
X7T = "countries/c_samarenda.txt"
X7U = "countries/c_samawa.txt"
X7V = "countries/c_samboangan.txt"
X7W = "countries/c_sambor_prei_kuk.txt"
X7X = "countries/c_sanda.txt"
X7Y = "countries/c_sandomierska.txt"
X7Z = "countries/c_sangata.txt"
X80 = "countries/c_saoura.txt"
X81 = "countries/c_sarangani.txt"
X82 = "countries/c_savalu.txt"
X83 = "countries/c_sawai.txt"
X84 = "countries/c_say_fong.txt"
X85 = "countries/c_sayaburi.txt"
X86 = "countries/c_saysetha.txt"
X87 = "countries/c_scalovia.txt"
X88 = "countries/c_seberaung.txt"
X89 = "countries/c_sekala_brak.txt"
X8A = "countries/c_seko.txt"
X8B = "countries/c_sekong.txt"
X8C = "countries/c_selayar.txt"
X8D = "countries/c_semey.txt"
X8E = "countries/c_senmonorom.txt"
X8F = "countries/c_seno.txt"
X8G = "countries/c_seponh.txt"
X8H = "countries/c_seruyan_hulu.txt"
X8I = "countries/c_shaanzhou_china.txt"
X8J = "countries/c_shangzhou_qin_china.txt"
X8K = "countries/c_shaoguan_guang_china.txt"
X8L = "countries/c_shaozhou_hunan_china.txt"
X8M = "countries/c_sharka.txt"
X8N = "countries/c_shavgar.txt"
X8O = "countries/c_shchuchinsk.txt"
X8P = "countries/c_shengzhou_china.txt"
X8Q = "countries/c_shenkursk.txt"
X8R = "countries/c_shenzhou_china.txt"
X8S = "countries/c_shenzhou_hebei_china.txt"
X8T = "countries/c_sherbro.txt"
X8U = "countries/c_shetland.txt"
X8V = "countries/c_shezhou_china.txt"
X8W = "countries/c_shizhou_china.txt"
X8X = "countries/c_shorkot.txt"
X8Y = "countries/c_shouchun_china.txt"
X8Z = "countries/c_shuaibin_china.txt"
X90 = "countries/c_shuozhou_china.txt"
X91 = "countries/c_shuzhou_huai_china.txt"
X92 = "countries/c_si_thep.txt"
X93 = "countries/c_sialo.txt"
X94 = "countries/c_sidamo.txt"
X95 = "countries/c_sidenreng.txt"
X96 = "countries/c_sieradzka.txt"
X97 = "countries/c_siezhou_china.txt"
X98 = "countries/c_siggevara.txt"
X99 = "countries/c_sighnaq.txt"
X9A = "countries/c_sijilmasa.txt"
X9B = "countries/c_sikasso.txt"
X9C = "countries/c_silla.txt"
X9D = "countries/c_simeulue.txt"
X9E = "countries/c_singhapura.txt"
X9F = "countries/c_singora.txt"
X9G = "countries/c_sitti.txt"
X9H = "countries/c_sizhou_xu_china.txt"
X9I = "countries/c_skolt.txt"
X9J = "countries/c_slupsk.txt"
X9K = "countries/c_slutsk.txt"
X9L = "countries/c_sochur.txt"
X9M = "countries/c_sogn.txt"
X9N = "countries/c_sojol.txt"
X9O = "countries/c_sokode.txt"
X9P = "countries/c_soldin.txt"
X9Q = "countries/c_solimana.txt"
X9R = "countries/c_sombio.txt"
X9S = "countries/c_son_la.txt"
X9T = "countries/c_sonburi.txt"
X9U = "countries/c_songshan_china.txt"
X9V = "countries/c_songzhou_song_china.txt"
X9W = "countries/c_sopeng.txt"
X9X = "countries/c_soren.txt"
X9Y = "countries/c_sorsogon.txt"
X9Z = "countries/c_sortavala.txt"
XAL = "countries/Xalisco.txt"
XIU = "countries/Xiu.txt"
Y00 = "countries/c_dizhou_china.txt"
Y01 = "countries/c_djado.txt"
Y02 = "countries/c_djanet.txt"
Y03 = "countries/c_dobrzynska.txt"
Y04 = "countries/c_dodugu.txt"
Y05 = "countries/c_dolgujar.txt"
Y06 = "countries/c_don.txt"
Y07 = "countries/c_dongping_yulou_china.txt"
Y08 = "countries/c_dorohychyn.txt"
Y09 = "countries/c_draa.txt"
Y0A = "countries/c_duanzhou_china.txt"
Y0B = "countries/c_dumangas.txt"
Y0C = "countries/c_dupaningan.txt"
Y0D = "countries/c_dushang_china.txt"
Y0E = "countries/c_dyamare.txt"
Y0F = "countries/c_east_darfur.txt"
Y0G = "countries/c_east_kiilt.txt"
Y0H = "countries/c_edd.txt"
Y0I = "countries/c_el_waak.txt"
Y0J = "countries/c_emil.txt"
Y0K = "countries/c_ennis.txt"
Y0L = "countries/c_enshi_china.txt"
Y0M = "countries/c_ewav.txt"
Y0N = "countries/c_ezhou_china.txt"
Y0O = "countries/c_faereyar.txt"
Y0P = "countries/c_fafan.txt"
Y0Q = "countries/c_fangzhou_china.txt"
Y0R = "countries/c_fangzhou_chu_china.txt"
Y0S = "countries/c_fante.txt"
Y0T = "countries/c_fellata.txt"
Y0U = "countries/c_fengxiang_china.txt"
Y0V = "countries/c_fengzhou_hanzhong_china.txt"
Y0W = "countries/c_fenzhou_china.txt"
Y0X = "countries/c_fetegar.txt"
Y0Y = "countries/c_fika.txt"
Y0Z = "countries/c_firdafylki.txt"
Y10 = "countries/c_french_leon.txt"
Y11 = "countries/c_fudalhi.txt"
Y12 = "countries/c_fuerteventura.txt"
Y13 = "countries/c_fushuizhou_china.txt"
Y14 = "countries/c_fuyu_china.txt"
Y15 = "countries/c_fuzhou_ba_china.txt"
Y16 = "countries/c_fuzhou_chu_china.txt"
Y17 = "countries/c_fuzhou_jiangxi_china.txt"
Y18 = "countries/c_fuzhou_qin_china.txt"
Y19 = "countries/c_fuzou_china.txt"
Y1A = "countries/c_gabal.txt"
Y1B = "countries/c_galam.txt"
Y1C = "countries/c_galban.txt"
Y1D = "countries/c_gallura.txt"
Y1E = "countries/c_gaolan_china.txt"
Y1F = "countries/c_gaozhou_china.txt"
Y1G = "countries/c_garoua.txt"
Y1H = "countries/c_gatsuurgazar.txt"
Y1I = "countries/c_gauldala.txt"
Y1J = "countries/c_geba.txt"
Y1K = "countries/c_gen_china.txt"
Y1L = "countries/c_germa.txt"
Y1M = "countries/c_ghardaia.txt"
Y1N = "countries/c_ghat.txt"
Y1O = "countries/c_ghazzal.txt"
Y1P = "countries/c_ghulja.txt"
Y1Q = "countries/c_gobir.txt"
Y1R = "countries/c_gode.txt"
Y1S = "countries/c_gola.txt"
Y1T = "countries/c_gondo.txt"
Y1U = "countries/c_gonja.txt"
Y1V = "countries/c_gorlitz.txt"
Y1W = "countries/c_gostyninska.txt"
Y1X = "countries/c_grebo.txt"
Y1Y = "countries/c_guangde_china.txt"
Y1Z = "countries/c_guangzhou_huainan_china.txt"
Y20 = "countries/c_guanling.txt"
Y21 = "countries/c_guilin_china.txt"
Y22 = "countries/c_guizhou_yan_china.txt"
Y23 = "countries/c_guozhou_ba_china.txt"
Y24 = "countries/c_guozhou_zhou_china.txt"
Y25 = "countries/c_guwari.txt"
Y26 = "countries/c_guzhu_china.txt"
Y27 = "countries/c_hailar_china.txt"
Y28 = "countries/c_haizhou_xu_china.txt"
Y29 = "countries/c_haka_china.txt"
Y2A = "countries/c_halych.txt"
Y2B = "countries/c_hangzhou_china.txt"
Y2C = "countries/c_hantik.txt"
Y2D = "countries/c_hantuman.txt"
Y2E = "countries/c_hanzhou_shu_china.txt"
Y2F = "countries/c_haozhou_huainan_china.txt"
Y2G = "countries/c_harikela.txt"
Y2H = "countries/c_harjadalen.txt"
Y2I = "countries/c_harrat_rahat.txt"
Y2J = "countries/c_hayq.txt"
Y2K = "countries/c_helan_china.txt"
Y2L = "countries/c_helgum.txt"
Y2M = "countries/c_helong.txt"
Y2N = "countries/c_hengshan_china.txt"
Y2O = "countries/c_hengzhou_china.txt"
Y2P = "countries/c_hequ_china.txt"
Y2Q = "countries/c_hereti.txt"
Y2R = "countries/c_hezhou_ba_china.txt"
Y2S = "countries/c_hezhou_china.txt"
Y2T = "countries/c_hezhou_huai_china.txt"
Y2U = "countries/c_himologan.txt"
Y2V = "countries/c_hiraab.txt"
Y2W = "countries/c_hiyaxu_china.txt"
Y2X = "countries/c_hkamti.txt"
Y2Y = "countries/c_hoan_chau.txt"
Y2Z = "countries/c_hohoxe.txt"
Y30 = "countries/c_holonnor_china.txt"
Y31 = "countries/c_hongzhou_china.txt"
Y32 = "countries/c_hopang.txt"
Y33 = "countries/c_hordalandi.txt"
Y34 = "countries/c_horhnajubur_china.txt"
Y35 = "countries/c_houaphanh.txt"
Y36 = "countries/c_hsipaw.txt"
Y37 = "countries/c_huai_sai.txt"
Y38 = "countries/c_huaiyin_china.txt"
Y39 = "countries/c_huaizhou_zhou_china.txt"
Y3A = "countries/c_huanglong_china.txt"
Y3B = "countries/c_huangzhou_china.txt"
Y3C = "countries/c_huazhou_liang_china.txt"
Y3D = "countries/c_huazhou_pingyi_china.txt"
Y3E = "countries/c_hubek.txt"
Y3F = "countries/c_huhan_china.txt"
Y3G = "countries/c_huizhou_china.txt"
Y3H = "countries/c_hulondalo.txt"
Y3I = "countries/c_huzhou_wu_china.txt"
Y3J = "countries/c_hwando_china.txt"
Y3K = "countries/c_ibabao.txt"
Y3L = "countries/c_ibibo.txt"
Y3M = "countries/c_idoma.txt"
Y3N = "countries/c_ifat.txt"
Y3O = "countries/c_ifni.txt"
Y3P = "countries/c_igala.txt"
Y3Q = "countries/c_igana.txt"
Y3R = "countries/c_igbo.txt"
Y3S = "countries/c_ijaw.txt"
Y3T = "countries/c_ilga.txt"
Y3U = "countries/c_ilianen.txt"
Y3V = "countries/c_ilo.txt"
Y3W = "countries/c_ilog.txt"
Y3X = "countries/c_ilorin.txt"
Y3Y = "countries/c_inari.txt"
Y3Z = "countries/c_indrapura.txt"
Y40 = "countries/c_ipolot.txt"
Y41 = "countries/c_irarutu.txt"
Y42 = "countries/c_irkutsk.txt"
Y43 = "countries/c_ishim.txt"
Y44 = "countries/c_iviza.txt"
Y45 = "countries/c_jalmat.txt"
Y46 = "countries/c_jame.txt"
Y47 = "countries/c_jamtfir.txt"
Y48 = "countries/c_jara.txt"
Y49 = "countries/c_jarai.txt"
Y4A = "countries/c_jarawa.txt"
Y4B = "countries/c_jasky_kart.txt"
Y4C = "countries/c_jawi_jawi.txt"
Y4D = "countries/c_jend.txt"
Y4E = "countries/c_jeneponto.txt"
Y4F = "countries/c_jersika.txt"
Y4G = "countries/c_jiangzhou_china.txt"
Y4H = "countries/c_jiangzhou_wu_china.txt"
Y4I = "countries/c_jianzhou_bohai_china.txt"
Y4J = "countries/c_jianzhou_min_china.txt"
Y4K = "countries/c_jianzhou_shu2_china.txt"
Y4L = "countries/c_jianzhou_shu_china.txt"
Y4M = "countries/c_jiazhou_xichuan_china.txt"
Y4N = "countries/c_jilib.txt"
Y4O = "countries/c_jilizhou_china.txt"
Y4P = "countries/c_jingbianjun_china.txt"
Y4Q = "countries/c_jinghiz.txt"
Y4R = "countries/c_jingzhou_chu_china.txt"
Y4S = "countries/c_jingzhou_xia_china.txt"
Y4T = "countries/c_jinling_china.txt"
Y4U = "countries/c_jinsko.txt"
Y4V = "countries/c_jinzhou_hanzhong_china.txt"
Y4W = "countries/c_jinzhou_hezhong_china.txt"
Y4X = "countries/c_jiren_suat.txt"
Y4Y = "countries/c_jizhou_jiangxi_china.txt"
Y4Z = "countries/c_jizhou_liang_china.txt"
Y50 = "countries/c_jizhou_yan_china.txt"
Y51 = "countries/c_jizhou_zhao_china.txt"
Y52 = "countries/c_jovvkuj.txt"
Y53 = "countries/c_jowol.txt"
Y54 = "countries/c_jubba.txt"
Y55 = "countries/c_julevadno.txt"
Y56 = "countries/c_julop_china.txt"
Y57 = "countries/c_junzhou_china.txt"
Y58 = "countries/c_juzhou_china.txt"
Y59 = "countries/c_ka_long.txt"
Y5A = "countries/c_kabaena.txt"
Y5B = "countries/c_kabarasana.txt"
Y5C = "countries/c_kabeyawan.txt"
Y5D = "countries/c_kada.txt"
Y5E = "countries/c_kadam.txt"
Y5F = "countries/c_kagha.txt"
Y5G = "countries/c_kainggyaung.txt"
Y5H = "countries/c_kainuu.txt"
Y5I = "countries/c_kakheti.txt"
Y5J = "countries/c_kakisalmi.txt"
Y5K = "countries/c_kalbin.txt"
Y5L = "countries/c_kalinga.txt"
Y5M = "countries/c_kambera.txt"
Y5N = "countries/c_kampong_kdei.txt"
Y5O = "countries/c_kangra.txt"
Y5P = "countries/c_kankabatok.txt"
Y5Q = "countries/c_kapaur.txt"
Y5R = "countries/c_kapit.txt"
Y5S = "countries/c_karabaigal.txt"
Y5T = "countries/c_karabas.txt"
Y5U = "countries/c_karabash.txt"
Y5V = "countries/c_karakelong.txt"
Y5W = "countries/c_karamay.txt"
Y5X = "countries/c_karasjohka.txt"
Y5Y = "countries/c_karasu.txt"
Y5Z = "countries/c_karat_china.txt"
Y60 = "countries/c_kargadan.txt"
Y61 = "countries/c_kargopol.txt"
Y62 = "countries/c_karkaraly.txt"
Y63 = "countries/c_kasa.txt"
Y64 = "countries/c_kash.txt"
Y65 = "countries/c_kasiguran.txt"
Y66 = "countries/c_katagum.txt"
Y67 = "countries/c_katanduan.txt"
Y68 = "countries/c_katingan_hilir.txt"
Y69 = "countries/c_kawkareik.txt"
Y6A = "countries/c_kayor.txt"
Y6B = "countries/c_kazanskoye.txt"
Y6C = "countries/c_kazym.txt"
Y6D = "countries/c_kebbi.txt"
Y6E = "countries/c_keffi.txt"
Y6F = "countries/c_kelay.txt"
Y6G = "countries/c_kendari.txt"
Y6H = "countries/c_kengcheng.txt"
Y6I = "countries/c_kera.txt"
Y6J = "countries/c_kevrola.txt"
Y6K = "countries/c_khachen.txt"
Y6L = "countries/c_khamkeut.txt"
Y6M = "countries/c_khantabouli.txt"
Y6N = "countries/c_khatan_china.txt"
Y6O = "countries/c_khiyat_china.txt"
Y6P = "countries/c_kholmogory.txt"
Y6Q = "countries/c_khu_bua.txt"
Y6R = "countries/c_kinabalu.txt"
Y6S = "countries/c_kinabatangan.txt"
Y6T = "countries/c_kinda_sakun.txt"
Y6U = "countries/c_kintus.txt"
Y6V = "countries/c_kirillov.txt"
Y6W = "countries/c_kirluk_china.txt"
Y6X = "countries/c_kisi.txt"
Y6Y = "countries/c_kitka.txt"
Y6Z = "countries/c_kitoi.txt"
Y70 = "countries/c_kittila.txt"
Y71 = "countries/c_kletsk.txt"
Y72 = "countries/c_kluet.txt"
Y73 = "countries/c_koda.txt"
Y74 = "countries/c_koi-bagar.txt"
Y75 = "countries/c_kokoli.txt"
Y76 = "countries/c_kokpekty.txt"
Y77 = "countries/c_kolaka.txt"
Y78 = "countries/c_kolobrzeg.txt"
Y79 = "countries/c_kon_tum.txt"
Y7A = "countries/c_kongmeng_china.txt"
Y7B = "countries/c_koningau.txt"
Y7C = "countries/c_konko.txt"
Y7D = "countries/c_kono.txt"
Y7E = "countries/c_konyan.txt"
Y7F = "countries/c_koshuki.txt"
Y7G = "countries/c_kotabatu.txt"
Y7H = "countries/c_kotera.txt"
Y7I = "countries/c_kotoko.txt"
Y7J = "countries/c_kozelsk.txt"
Y7K = "countries/c_kraburi.txt"
Y7L = "countries/c_krajna.txt"
Y7M = "countries/c_kraong.txt"
Y7N = "countries/c_kru.txt"
Y7O = "countries/c_kuala_kurun.txt"
Y7P = "countries/c_kuisugu.txt"
Y7Q = "countries/c_kuizhou_china.txt"
Y7R = "countries/c_kujawy.txt"
Y7S = "countries/c_kuku.txt"
Y7T = "countries/c_kulan_utmas.txt"
Y7U = "countries/c_kulan_uynak.txt"
Y7V = "countries/c_kumalarang.txt"
Y7W = "countries/c_kumasi.txt"
Y7X = "countries/c_kuozhou_yue_china.txt"
Y7Y = "countries/c_kuranko.txt"
Y7Z = "countries/c_kurgan.txt"
Y80 = "countries/c_kurmina.txt"
Y81 = "countries/c_kush-murun.txt"
Y82 = "countries/c_kusinagara.txt"
Y83 = "countries/c_kwahu-akyem.txt"
Y84 = "countries/c_kwararafa.txt"
Y85 = "countries/c_kyadya.txt"
Y86 = "countries/c_kyaukse.txt"
Y87 = "countries/c_kymyl_tey.txt"
Y88 = "countries/c_lach.txt"
Y89 = "countries/c_lachyk-uba.txt"
Y8A = "countries/c_lag_dera.txt"
Y8B = "countries/c_lagawe.txt"
Y8C = "countries/c_laghwat.txt"
Y8D = "countries/c_laia.txt"
Y8E = "countries/c_laikha.txt"
Y8F = "countries/c_laizhou_china.txt"
Y8G = "countries/c_lamandau.txt"
Y8H = "countries/c_lambunu.txt"
Y8I = "countries/c_lampang.txt"
Y8J = "countries/c_landsberg.txt"
Y8K = "countries/c_langxi_china.txt"
Y8L = "countries/c_langzhou_ba_china.txt"
Y8M = "countries/c_langzhou_chu_china.txt"
Y8N = "countries/c_lanzhou_hedong_china.txt"
Y8O = "countries/c_lanzhou_longxi_china.txt"
Y8P = "countries/c_larantuka.txt"
Y8Q = "countries/c_larompong.txt"
Y8R = "countries/c_lasusua.txt"
Y8S = "countries/c_lebak.txt"
Y8T = "countries/c_leczycka.txt"
Y8U = "countries/c_lemukutan.txt"
Y8V = "countries/c_lena.txt"
Y8W = "countries/c_leraba.txt"
Y8X = "countries/c_leti.txt"
Y8Y = "countries/c_liangzhou_huangzhou_china.txt"
Y8Z = "countries/c_lianzhou_china.txt"
Y90 = "countries/c_lianzhou_gui_china.txt"
Y91 = "countries/c_liaodong_china.txt"
Y92 = "countries/c_ligao_china.txt"
Y93 = "countries/c_lingzhou_xichuan_china.txt"
Y94 = "countries/c_linzhou_shaan_china.txt"
Y95 = "countries/c_lizhou_chu_china.txt"
Y96 = "countries/c_lizhou_hanzhong_china.txt"
Y97 = "countries/c_lizhou_shu_china.txt"
Y98 = "countries/c_lo.txt"
Y99 = "countries/c_lobo.txt"
Y9A = "countries/c_loei.txt"
Y9B = "countries/c_logudoro.txt"
Y9C = "countries/c_loi_long.txt"
Y9D = "countries/c_lolak.txt"
Y9E = "countries/c_lombok.txt"
Y9F = "countries/c_lomlom.txt"
Y9G = "countries/c_lomzynska.txt"
Y9H = "countries/c_long_seridan.txt"
Y9I = "countries/c_longhua_china.txt"
Y9J = "countries/c_longyuan_china.txt"
Y9K = "countries/c_longzhou_china.txt"
Y9L = "countries/c_longzhou_shu_china.txt"
Y9M = "countries/c_loropeni.txt"
Y9N = "countries/c_lotan_china.txt"
Y9O = "countries/c_lubelska.txt"
Y9P = "countries/c_lubusz.txt"
Y9Q = "countries/c_lumajang.txt"
Y9R = "countries/c_luodian.txt"
Y9S = "countries/c_luoyang_china.txt"
Y9T = "countries/c_luqu_valley_china.txt"
Y9U = "countries/c_luwuk.txt"
Y9V = "countries/c_luyang_china.txt"
Y9W = "countries/c_luzhou_annan_china.txt"
Y9X = "countries/c_luzhou_dongchuan_china.txt"
Y9Y = "countries/c_luzhou_huai_china.txt"
Y9Z = "countries/c_luzhou_jin_china.txt"
YAK = "countries/Yaka.txt"
YAN = "countries/Yan.txt"
YAO = "countries/Yao.txt"
YAQ = "countries/Yaqui.txt"
YAR = "countries/Yaroslavl.txt"
YAS = "countries/Yas.txt"
YAT = "countries/Yatenga.txt"
YEM = "countries/Yemen.txt"
YKT = "countries/Yokuts.txt"
YMN = "countries/Yamana.txt"
YNU = "countries/Yanuwa.txt"
YOK = "countries/Yokotan.txt"
YOL = "countries/Yolngu.txt"
YOR = "countries/Andhra.txt"
YUA = "countries/GreatYuan.txt"
YUE = "countries/Yue.txt"
YZD = "countries/Yazd.txt"
Z00 = "countries/e_caspian-pontic_steppe.txt"
Z01 = "countries/e_kambujadesa.txt"
Z02 = "countries/e_kirghiz_khanate.txt"
Z03 = "countries/e_nanzhao.txt"
Z04 = "countries/k_aquitaine.txt"
Z05 = "countries/k_bihar.txt"
Z06 = "countries/k_ghana.txt"
Z07 = "countries/k_guiyi.txt"
Z08 = "countries/k_karnata.txt"
Z09 = "countries/k_khotan.txt"
Z0A = "countries/k_kosala.txt"
Z0B = "countries/k_lulong.txt"
Z0C = "countries/k_maharastra.txt"
Z0D = "countries/k_oghuz_il.txt"
Z0E = "countries/k_tagaung.txt"
Z0F = "countries/k_zhetysu.txt"
Z0G = "countries/d_aarjetje.txt"
Z0H = "countries/d_adrar.txt"
Z0I = "countries/d_apulia.txt"
Z0J = "countries/d_bangkahulu.txt"
Z0K = "countries/d_baqlin.txt"
Z0L = "countries/d_bazin.txt"
Z0M = "countries/d_benevento.txt"
Z0N = "countries/d_bima.txt"
Z0O = "countries/d_borgu.txt"
Z0P = "countries/d_bukovina.txt"
Z0Q = "countries/d_carinthia.txt"
Z0R = "countries/d_chattogram.txt"
Z0S = "countries/d_chera_nadu.txt"
Z0T = "countries/d_chiang_saen.txt"
Z0U = "countries/d_chola_nadu.txt"
Z0V = "countries/d_dabaw.txt"
Z0W = "countries/d_daksina_kosala.txt"
Z0X = "countries/d_dalir.txt"
Z0Y = "countries/d_dauria.txt"
Z0Z = "countries/d_deheubarth.txt"
Z10 = "countries/d_eastern_desert.txt"
Z11 = "countries/d_eweland.txt"
Z12 = "countries/d_galloway.txt"
Z13 = "countries/d_galuh.txt"
Z14 = "countries/d_gayo.txt"
Z15 = "countries/d_ghur.txt"
Z16 = "countries/d_gojjam.txt"
Z17 = "countries/d_gwynedd.txt"
Z18 = "countries/d_gyor.txt"
Z19 = "countries/d_hamadan.txt"
Z1A = "countries/d_haripunjaya.txt"
Z1B = "countries/d_hereford.txt"
Z1C = "countries/d_hkamti.txt"
Z1D = "countries/d_ife.txt"
Z1E = "countries/d_jawf-al-yamani.txt"
Z1F = "countries/d_jylland.txt"
Z1G = "countries/d_kabul.txt"
Z1H = "countries/d_kalinga.txt"
Z1I = "countries/d_kashgar.txt"
Z1J = "countries/d_kawkaw.txt"
Z1K = "countries/d_kengtung.txt"
Z1L = "countries/d_konda.txt"
Z1M = "countries/d_krapan.txt"
Z1N = "countries/d_kuripan.txt"
Z1O = "countries/d_kurmanchal.txt"
Z1P = "countries/d_lobi.txt"
Z1Q = "countries/d_lower_silesia.txt"
Z1R = "countries/d_macva.txt"
Z1S = "countries/d_mae_si.txt"
Z1T = "countries/d_mesopotamia.txt"
Z1U = "countries/d_minsk.txt"
Z1V = "countries/d_mongnai.txt"
Z1W = "countries/d_mongpai.txt"
Z1X = "countries/d_mugodzhar_hills.txt"
Z1Y = "countries/d_myinmu.txt"
Z1Z = "countries/d_nagur.txt"
Z20 = "countries/d_nakhon_phanom.txt"
Z21 = "countries/d_nan.txt"
Z22 = "countries/d_naqis.txt"
Z23 = "countries/d_nong.txt"
Z24 = "countries/d_norfolk.txt"
Z25 = "countries/d_north_shan.txt"
Z26 = "countries/d_panai.txt"
Z27 = "countries/d_pandya_nadu.txt"
Z28 = "countries/d_phetchabun.txt"
Z29 = "countries/d_phongsali.txt"
Z2A = "countries/d_powys.txt"
Z2B = "countries/d_rattapadi.txt"
Z2C = "countries/d_salerno.txt"
Z2D = "countries/d_samogitia.txt"
Z2E = "countries/d_sanaa.txt"
Z2F = "countries/d_santubong.txt"
Z2G = "countries/d_saryarka.txt"
Z2H = "countries/d_sennar.txt"
Z2I = "countries/d_sizhou.txt"
Z2J = "countries/d_sjaelland.txt"
Z2K = "countries/d_slavonia.txt"
Z2L = "countries/d_smaland.txt"
Z2M = "countries/d_socotra.txt"
Z2N = "countries/d_somerset.txt"
Z2O = "countries/d_somogy.txt"
Z2P = "countries/d_sriksetra.txt"
Z2Q = "countries/d_syrte.txt"
Z2R = "countries/d_taizz.txt"
Z2S = "countries/d_tak.txt"
Z2T = "countries/d_takrur.txt"
Z2U = "countries/d_tanjungpura.txt"
Z2V = "countries/d_thaton.txt"
Z2W = "countries/d_tondai_nadu.txt"
Z2X = "countries/d_tosali.txt"
Z2Y = "countries/d_transcarpathia.txt"
Z2Z = "countries/d_turgay.txt"
Z30 = "countries/d_turov.txt"
Z31 = "countries/d_u_thong.txt"
Z32 = "countries/d_udayagiri.txt"
Z33 = "countries/d_udmurtia.txt"
Z34 = "countries/d_ungvar.txt"
Z35 = "countries/d_ural.txt"
Z36 = "countries/d_vanga.txt"
Z37 = "countries/d_vastergotland.txt"
Z38 = "countries/d_vengi.txt"
Z39 = "countries/d_vepsia.txt"
Z3A = "countries/d_wielkopolska.txt"
Z3B = "countries/d_wijayapura.txt"
Z3C = "countries/d_wuluhai.txt"
Z3D = "countries/d_yamama.txt"
Z3E = "countries/d_yawnghwe.txt"
Z3F = "countries/d_yijinai.txt"
Z3G = "countries/d_york.txt"
Z3H = "countries/d_zab.txt"
Z3I = "countries/d_zhenfan.txt"
Z3J = "countries/c_aborlan.txt"
Z3K = "countries/c_abuyog.txt"
Z3L = "countries/c_achu_china.txt"
Z3M = "countries/c_adanse.txt"
Z3N = "countries/c_agadir.txt"
Z3O = "countries/c_agdeside.txt"
Z3P = "countries/c_agoo.txt"
Z3Q = "countries/c_agung_baru.txt"
Z3R = "countries/c_ahqaf.txt"
Z3S = "countries/c_ain_galakka.txt"
Z3T = "countries/c_akean.txt"
Z3U = "countries/c_akkel.txt"
Z3V = "countries/c_al-asa.txt"
Z3W = "countries/c_albay.txt"
Z3X = "countries/c_alor.txt"
Z3Y = "countries/c_amfoan.txt"
Z3Z = "countries/c_amhara.txt"
Z40 = "countries/c_amis.txt"
Z41 = "countries/c_ampana.txt"
Z42 = "countries/c_anambas.txt"
Z43 = "countries/c_anbian_china.txt"
Z44 = "countries/c_angermanland.txt"
Z45 = "countries/c_angot.txt"
Z46 = "countries/c_anh_son.txt"
Z47 = "countries/c_aninditapura.txt"
Z48 = "countries/c_anju_china.txt"
Z49 = "countries/c_anle_china.txt"
Z4A = "countries/c_anlong_china.txt"
Z4B = "countries/c_anshi_china.txt"
Z4C = "countries/c_anyuan_china.txt"
Z4D = "countries/c_anzhou_china.txt"
Z4E = "countries/c_aowin.txt"
Z4F = "countries/c_aparri.txt"
Z4G = "countries/c_aqtobe.txt"
Z4H = "countries/c_aran.txt"
Z4I = "countries/c_arborea.txt"
Z4J = "countries/c_argun_china.txt"
Z4K = "countries/c_arkat.txt"
Z4L = "countries/c_aru_east.txt"
Z4M = "countries/c_arusi.txt"
Z4N = "countries/c_asfi.txt"
Z4O = "countries/c_atayal.txt"
Z4P = "countries/c_atbasar.txt"
Z4Q = "countries/c_attie.txt"
Z4R = "countries/c_austisland.txt"
Z4S = "countries/c_aviovara.txt"
Z4T = "countries/c_awssa.txt"
Z4U = "countries/c_ayn_farah.txt"
Z4V = "countries/c_ayun_pa.txt"
Z4W = "countries/c_ayutthaya.txt"
Z4X = "countries/c_babar.txt"
Z4Y = "countries/c_babruysk.txt"
Z4Z = "countries/c_baganga.txt"
Z50 = "countries/c_baggao.txt"
Z51 = "countries/c_baguirmi.txt"
Z52 = "countries/c_bahnar.txt"
Z53 = "countries/c_baigaluuls.txt"
Z54 = "countries/c_baigaur.txt"
Z55 = "countries/c_baisary.txt"
Z56 = "countries/c_baishan_china.txt"
Z57 = "countries/c_bakulud.txt"
Z58 = "countries/c_bakumpai.txt"
Z59 = "countries/c_balaesang.txt"
Z5A = "countries/c_balayan.txt"
Z5B = "countries/c_balintang.txt"
Z5C = "countries/c_ban_yaeng.txt"
Z5D = "countries/c_bandiagara.txt"
Z5E = "countries/c_banggai.txt"
Z5F = "countries/c_banjarmasin.txt"
Z5G = "countries/c_banoi.txt"
Z5H = "countries/c_banre.txt"
Z5I = "countries/c_bao_lac.txt"
Z5J = "countries/c_baol.txt"
Z5K = "countries/c_barbacadle.txt"
Z5L = "countries/c_bardak.txt"
Z5M = "countries/c_barma.txt"
Z5N = "countries/c_basagha.txt"
Z5O = "countries/c_basap.txt"
Z5P = "countries/c_basay.txt"
Z5Q = "countries/c_bassa.txt"
Z5R = "countries/c_bauchi.txt"
Z5S = "countries/c_bayanterm_china.txt"
Z5T = "countries/c_baydhabo.txt"
Z5U = "countries/c_bayombong.txt"
Z5V = "countries/c_bazhou_ba_china.txt"
Z5W = "countries/c_begho.txt"
Z5X = "countries/c_beian_china.txt"
Z5Y = "countries/c_beikthano.txt"
Z5Z = "countries/c_beizhou_china.txt"
Z60 = "countries/c_belaga.txt"
Z61 = "countries/c_belebey.txt"
Z62 = "countries/c_belogorje.txt"
Z63 = "countries/c_belu.txt"
Z64 = "countries/c_belz.txt"
Z65 = "countries/c_bena.txt"
Z66 = "countries/c_berau.txt"
Z67 = "countries/c_berbera.txt"
Z68 = "countries/c_berent.txt"
Z69 = "countries/c_berestye.txt"
Z6A = "countries/c_berlin.txt"
Z6B = "countries/c_betpa.txt"
Z6C = "countries/c_beturube.txt"
Z6D = "countries/c_bhera.txt"
Z6E = "countries/c_bianzhou_china.txt"
Z6F = "countries/c_binalatongan.txt"
Z6G = "countries/c_binalbagan.txt"
Z6H = "countries/c_binangonan.txt"
Z6I = "countries/c_bindugu.txt"
Z6J = "countries/c_binnaka.txt"
Z6K = "countries/c_bintulu.txt"
Z6L = "countries/c_binzhou_gui_china.txt"
Z6M = "countries/c_binzhou_qin_china.txt"
Z6N = "countries/c_bisha.txt"
Z6O = "countries/c_biun.txt"
Z6P = "countries/c_blao.txt"
Z6Q = "countries/c_bo_ol.txt"
Z6R = "countries/c_bodele.txt"
Z6S = "countries/c_bolinao.txt"
Z6T = "countries/c_bolo_ph.txt"
Z6U = "countries/c_bombana.txt"
Z6V = "countries/c_bonduku.txt"
Z6W = "countries/c_bonoso.txt"
Z6X = "countries/c_boron.txt"
Z6Y = "countries/c_borongan.txt"
Z6Z = "countries/c_bothin.txt"
Z70 = "countries/c_boubo.txt"
Z71 = "countries/c_bozhou_song_china.txt"
Z72 = "countries/c_bozhou_wei_china.txt"
Z73 = "countries/c_bozhou_zunyi_china.txt"
Z74 = "countries/c_bratsk.txt"
Z75 = "countries/c_brecknockshire.txt"
Z76 = "countries/c_bualemo.txt"
Z77 = "countries/c_buayan.txt"
Z78 = "countries/c_bugurslan.txt"
Z79 = "countries/c_bugyas.txt"
Z7A = "countries/c_bukidnon.txt"
Z7B = "countries/c_bukit_raya.txt"
Z7C = "countries/c_bula.txt"
Z7D = "countries/c_bulukumba.txt"
Z7E = "countries/c_bundu.txt"
Z7F = "countries/c_bungku.txt"
Z7G = "countries/c_bunun.txt"
Z7H = "countries/c_buol.txt"
Z7I = "countries/c_bur.txt"
Z7J = "countries/c_bura.txt"
Z7K = "countries/c_burau.txt"
Z7L = "countries/c_burji.txt"
Z7M = "countries/c_buru.txt"
Z7N = "countries/c_burubur.txt"
Z7O = "countries/c_buruwai.txt"
Z7P = "countries/c_busaso.txt"
Z7Q = "countries/c_bussa.txt"
Z7R = "countries/c_busuanga.txt"
Z7S = "countries/c_buyur_china.txt"
Z7T = "countries/c_cagliari.txt"
Z7U = "countries/c_caizhou_china.txt"
Z7V = "countries/c_cammin.txt"
Z7W = "countries/c_canarias.txt"
Z7X = "countries/c_cangzhou_china.txt"
Z7Y = "countries/c_caozhou_china.txt"
Z7Z = "countries/c_cardiganshire.txt"
Z80 = "countries/c_carmarthenshire.txt"
Z81 = "countries/c_chadrinsk.txt"
Z82 = "countries/c_chakangrao.txt"
Z83 = "countries/c_changchun_china.txt"
Z84 = "countries/c_changling_china.txt"
Z85 = "countries/c_changsha_china.txt"
Z86 = "countries/c_changwu_china.txt"
Z87 = "countries/c_changzhou_china.txt"
Z88 = "countries/c_chantabuli.txt"
Z89 = "countries/c_chanyufu_china.txt"
Z8A = "countries/c_chanzhou_china.txt"
Z8B = "countries/c_chaozhou_china.txt"
Z8C = "countries/c_chatigama.txt"
Z8D = "countries/c_cheboksary.txt"
Z8E = "countries/c_chelabinsk.txt"
Z8F = "countries/c_chengdu_china.txt"
Z8G = "countries/c_chengtianjun_china.txt"
Z8H = "countries/c_chenxi_china.txt"
Z8I = "countries/c_chenzhou_china.txt"
Z8J = "countries/c_chenzhou_hunan_china.txt"
Z8K = "countries/c_cherven.txt"
Z8L = "countries/c_chiang_hung.txt"
Z8M = "countries/c_chich.txt"
Z8N = "countries/c_chiya_china.txt"
Z8O = "countries/c_chizhou_china.txt"
Z8P = "countries/c_cho_ro.txt"
Z8Q = "countries/c_choklema.txt"
Z8R = "countries/c_chuguchak.txt"
Z8S = "countries/c_chuya.txt"
Z8T = "countries/c_chuzhou_huai_china.txt"
Z8U = "countries/c_cizhou_china.txt"
Z8V = "countries/c_cizhou_hezhong_china.txt"
Z8W = "countries/c_con_linh.txt"
Z8X = "countries/c_cykma.txt"
Z8Y = "countries/c_czerska.txt"
Z8Z = "countries/c_da_bac.txt"
Z90 = "countries/c_dabou.txt"
Z91 = "countries/c_daboya.txt"
Z92 = "countries/c_dading_china.txt"
Z93 = "countries/c_daet.txt"
Z94 = "countries/c_dagar.txt"
Z95 = "countries/c_daizhou_china.txt"
Z96 = "countries/c_dak_lak.txt"
Z97 = "countries/c_danakil.txt"
Z98 = "countries/c_danzhou_china.txt"
Z99 = "countries/c_daozhou_china.txt"
Z9A = "countries/c_dapitan.txt"
Z9B = "countries/c_dar-al-rih.txt"
Z9C = "countries/c_dar_al-said.txt"
Z9D = "countries/c_dar_rashid.txt"
Z9E = "countries/c_dar_sila.txt"
Z9F = "countries/c_dara.txt"
Z9G = "countries/c_dargu_china.txt"
Z9H = "countries/c_datadian.txt"
Z9I = "countries/c_daura.txt"
Z9J = "countries/c_dawaro.txt"
Z9K = "countries/c_dawei.txt"
Z9L = "countries/c_dayan_china.txt"
Z9M = "countries/c_degelen.txt"
Z9N = "countries/c_degere_china.txt"
Z9O = "countries/c_dendi.txt"
Z9P = "countries/c_dengzhou_china.txt"
Z9Q = "countries/c_derbent.txt"
Z9R = "countries/c_dezhou_wei_china.txt"
Z9S = "countries/c_dhofar.txt"
Z9T = "countries/c_diamare.txt"
Z9U = "countries/c_dibri.txt"
Z9V = "countries/c_dingli_china.txt"
Z9W = "countries/c_dingzhou_china.txt"
Z9X = "countries/c_dipalpur.txt"
Z9Y = "countries/c_divilikan.txt"
Z9Z = "countries/c_diyolongan.txt"
ZAF = "countries/Zafunu.txt"
ZAN = "countries/Swahili.txt"
ZAP = "countries/Zapotec.txt"
ZAZ = "countries/Zaporozhie.txt"
ZIM = "countries/Mutapa.txt"
ZND = "countries/Zandoma.txt"
ZNI = "countries/Zuni.txt"
ZUL = "countries/Zulu.txt"
ZUN = "countries/Zunghar.txt"
ZZZ = "countries/Zazzau.txt"

